,plan_id,plan_label,distr,vote_circ,vote_sqre,total
0,5171696720,0,1,117,133,250
1,5171696720,0,2,121,129,250
2,5171696720,0,3,141,109,250
3,5171696720,0,4,130,120,250
4,5171696720,0,5,129,121,250
5,5171696720,0,6,120,130,250
6,5045658960,1,1,120,143,263
7,5045658960,1,2,119,126,245
8,5045658960,1,3,126,120,246
9,5045658960,1,4,114,134,248
10,5045658960,1,5,140,112,252
11,5045658960,1,6,139,107,246
12,5171696784,2,1,113,137,250
13,5171696784,2,2,122,132,254
14,5171696784,2,3,135,121,256
15,5171696784,2,4,116,126,242
16,5171696784,2,5,133,117,250
17,5171696784,2,6,139,109,248
18,5171696848,3,1,112,131,243
19,5171696848,3,2,119,126,245
20,5171696848,3,3,138,123,261
21,5171696848,3,4,128,123,251
22,5171696848,3,5,134,112,246
23,5171696848,3,6,127,127,254
24,5171697040,4,1,112,131,243
25,5171697040,4,2,119,126,245
26,5171697040,4,3,138,123,261
27,5171697040,4,4,132,121,253
28,5171697040,4,5,134,112,246
29,5171697040,4,6,123,129,252
30,5171697296,5,1,135,126,261
31,5171697296,5,2,121,123,244
32,5171697296,5,3,116,123,239
33,5171697296,5,4,111,136,247
34,5171697296,5,5,130,122,252
35,5171697296,5,6,145,112,257
36,5171697424,6,1,118,139,257
37,5171697424,6,2,119,126,245
38,5171697424,6,3,136,121,257
39,5171697424,6,4,131,126,257
40,5171697424,6,5,135,109,244
41,5171697424,6,6,119,121,240
42,5171697488,7,1,120,143,263
43,5171697488,7,2,124,118,242
44,5171697488,7,3,136,102,238
45,5171697488,7,4,121,120,241
46,5171697488,7,5,122,131,253
47,5171697488,7,6,135,128,263
48,5171697616,8,1,114,141,255
49,5171697616,8,2,128,118,246
50,5171697616,8,3,136,102,238
51,5171697616,8,4,130,123,253
52,5171697616,8,5,118,131,249
53,5171697616,8,6,132,127,259
54,5171697168,9,1,115,135,250
55,5171697168,9,2,141,118,259
56,5171697168,9,3,137,109,246
57,5171697168,9,4,131,123,254
58,5171697168,9,5,111,133,244
59,5171697168,9,6,123,124,247
60,5171697744,10,1,115,135,250
61,5171697744,10,2,141,118,259
62,5171697744,10,3,137,109,246
63,5171697744,10,4,119,121,240
64,5171697744,10,5,111,133,244
65,5171697744,10,6,135,126,261
66,5171697872,11,1,113,128,241
67,5171697872,11,2,140,115,255
68,5171697872,11,3,136,116,252
69,5171697872,11,4,129,131,260
70,5171697872,11,5,116,134,250
71,5171697872,11,6,124,118,242
72,5171698064,12,1,122,133,255
73,5171698064,12,2,123,117,240
74,5171698064,12,3,138,121,259
75,5171698064,12,4,115,130,245
76,5171698064,12,5,139,121,260
77,5171698064,12,6,121,120,241
78,5171698192,13,1,129,132,261
79,5171698192,13,2,126,128,254
80,5171698192,13,3,135,103,238
81,5171698192,13,4,113,137,250
82,5171698192,13,5,121,121,242
83,5171698192,13,6,134,121,255
84,5171698320,14,1,138,115,253
85,5171698320,14,2,113,126,239
86,5171698320,14,3,134,123,257
87,5171698320,14,4,116,132,248
88,5171698320,14,5,115,135,250
89,5171698320,14,6,142,111,253
90,5171698576,15,1,118,133,251
91,5171698576,15,2,127,116,243
92,5171698576,15,3,128,118,246
93,5171698576,15,4,121,127,248
94,5171698576,15,5,125,136,261
95,5171698576,15,6,139,112,251
96,5171698704,16,1,129,114,243
97,5171698704,16,2,124,115,239
98,5171698704,16,3,123,119,242
99,5171698704,16,4,131,131,262
100,5171698704,16,5,135,121,256
101,5171698704,16,6,116,142,258
102,5171698832,17,1,143,117,260
103,5171698832,17,2,141,108,249
104,5171698832,17,3,116,127,243
105,5171698832,17,4,110,133,243
106,5171698832,17,5,128,118,246
107,5171698832,17,6,120,139,259
108,5171698960,18,1,121,140,261
109,5171698960,18,2,134,122,256
110,5171698960,18,3,119,126,245
111,5171698960,18,4,125,127,252
112,5171698960,18,5,126,113,239
113,5171698960,18,6,133,114,247
114,5171699088,19,1,112,127,239
115,5171699088,19,2,133,120,253
116,5171699088,19,3,119,126,245
117,5171699088,19,4,126,129,255
118,5171699088,19,5,133,123,256
119,5171699088,19,6,135,117,252
120,5171699344,20,1,126,113,239
121,5171699344,20,2,140,115,255
122,5171699344,20,3,116,134,250
123,5171699344,20,4,127,136,263
124,5171699344,20,5,136,116,252
125,5171699344,20,6,113,128,241
126,5171699472,21,1,126,115,241
127,5171699472,21,2,142,103,245
128,5171699472,21,3,111,133,244
129,5171699472,21,4,119,143,262
130,5171699472,21,5,137,121,258
131,5171699472,21,6,123,127,250
132,5171699600,22,1,126,117,243
133,5171699600,22,2,147,115,262
134,5171699600,22,3,130,127,257
135,5171699600,22,4,108,130,238
136,5171699600,22,5,122,125,247
137,5171699600,22,6,125,128,253
138,5174091856,23,1,126,117,243
139,5174091856,23,2,147,115,262
140,5174091856,23,3,130,127,257
141,5174091856,23,4,112,142,254
142,5174091856,23,5,122,125,247
143,5174091856,23,6,121,116,237
144,5174091984,24,1,122,118,240
145,5174091984,24,2,121,133,254
146,5174091984,24,3,146,104,250
147,5174091984,24,4,124,138,262
148,5174091984,24,5,121,123,244
149,5174091984,24,6,124,126,250
150,5174092112,25,1,126,133,259
151,5174092112,25,2,135,108,243
152,5174092112,25,3,124,122,246
153,5174092112,25,4,113,137,250
154,5174092112,25,5,118,131,249
155,5174092112,25,6,142,111,253
156,5174092368,26,1,122,123,245
157,5174092368,26,2,135,108,243
158,5174092368,26,3,128,132,260
159,5174092368,26,4,113,137,250
160,5174092368,26,5,118,131,249
161,5174092368,26,6,142,111,253
162,5174092496,27,1,122,141,263
163,5174092496,27,2,131,116,247
164,5174092496,27,3,127,126,253
165,5174092496,27,4,121,131,252
166,5174092496,27,5,121,123,244
167,5174092496,27,6,136,105,241
168,5174092624,28,1,136,125,261
169,5174092624,28,2,143,106,249
170,5174092624,28,3,123,137,260
171,5174092624,28,4,119,134,253
172,5174092624,28,5,113,126,239
173,5174092624,28,6,124,114,238
174,5174092752,29,1,113,124,237
175,5174092752,29,2,144,113,257
176,5174092752,29,3,130,126,256
177,5174092752,29,4,121,129,250
178,5174092752,29,5,113,126,239
179,5174092752,29,6,137,124,261
180,5174092880,30,1,127,131,258
181,5174092880,30,2,144,110,254
182,5174092880,30,3,125,122,247
183,5174092880,30,4,113,132,245
184,5174092880,30,5,113,126,239
185,5174092880,30,6,136,121,257
186,5174093008,31,1,142,117,259
187,5174093008,31,2,119,132,251
188,5174093008,31,3,130,112,242
189,5174093008,31,4,118,139,257
190,5174093008,31,5,119,126,245
191,5174093008,31,6,130,116,246
192,5174093136,32,1,139,116,255
193,5174093136,32,2,112,127,239
194,5174093136,32,3,137,117,254
195,5174093136,32,4,118,139,257
196,5174093136,32,5,119,126,245
197,5174093136,32,6,133,117,250
198,5174093264,33,1,127,112,239
199,5174093264,33,2,125,130,255
200,5174093264,33,3,139,119,258
201,5174093264,33,4,118,139,257
202,5174093264,33,5,117,127,244
203,5174093264,33,6,132,115,247
204,5174093392,34,1,141,108,249
205,5174093392,34,2,126,132,258
206,5174093392,34,3,108,135,243
207,5174093392,34,4,126,115,241
208,5174093392,34,5,133,128,261
209,5174093392,34,6,124,124,248
210,5174093520,35,1,141,108,249
211,5174093520,35,2,123,123,246
212,5174093520,35,3,111,144,255
213,5174093520,35,4,126,115,241
214,5174093520,35,5,133,128,261
215,5174093520,35,6,124,124,248
216,5174093648,36,1,136,116,252
217,5174093648,36,2,118,133,251
218,5174093648,36,3,117,140,257
219,5174093648,36,4,137,117,254
220,5174093648,36,5,132,117,249
221,5174093648,36,6,118,119,237
222,5174093776,37,1,141,120,261
223,5174093776,37,2,133,114,247
224,5174093776,37,3,106,140,246
225,5174093776,37,4,130,133,263
226,5174093776,37,5,132,108,240
227,5174093776,37,6,116,127,243
228,5174093904,38,1,133,122,255
229,5174093904,38,2,124,125,249
230,5174093904,38,3,110,135,245
231,5174093904,38,4,138,124,262
232,5174093904,38,5,140,110,250
233,5174093904,38,6,113,126,239
234,5174094032,39,1,117,120,237
235,5174094032,39,2,140,118,258
236,5174094032,39,3,122,139,261
237,5174094032,39,4,110,127,237
238,5174094032,39,5,141,110,251
239,5174094032,39,6,128,128,256
240,5174094160,40,1,131,112,243
241,5174094160,40,2,125,133,258
242,5174094160,40,3,115,128,243
243,5174094160,40,4,140,121,261
244,5174094160,40,5,121,120,241
245,5174094160,40,6,126,128,254
246,5174094288,41,1,122,126,248
247,5174094288,41,2,151,112,263
248,5174094288,41,3,110,132,242
249,5174094288,41,4,128,129,257
250,5174094288,41,5,124,125,249
251,5174094288,41,6,123,118,241
252,5174094416,42,1,119,119,238
253,5174094416,42,2,141,117,258
254,5174094416,42,3,110,132,242
255,5174094416,42,4,127,126,253
256,5174094416,42,5,131,125,256
257,5174094416,42,6,130,123,253
258,5174094544,43,1,119,119,238
259,5174094544,43,2,141,117,258
260,5174094544,43,3,110,132,242
261,5174094544,43,4,124,125,249
262,5174094544,43,5,134,126,260
263,5174094544,43,6,130,123,253
264,5174094672,44,1,133,108,241
265,5174094672,44,2,126,129,255
266,5174094672,44,3,119,127,246
267,5174094672,44,4,130,128,258
268,5174094672,44,5,137,124,261
269,5174094672,44,6,113,126,239
270,5174094800,45,1,139,121,260
271,5174094800,45,2,122,132,254
272,5174094800,45,3,134,116,250
273,5174094800,45,4,122,127,249
274,5174094800,45,5,128,120,248
275,5174094800,45,6,113,126,239
276,5174094928,46,1,128,135,263
277,5174094928,46,2,143,104,247
278,5174094928,46,3,113,137,250
279,5174094928,46,4,125,131,256
280,5174094928,46,5,124,119,243
281,5174094928,46,6,125,116,241
282,5174095056,47,1,143,112,255
283,5174095056,47,2,124,128,252
284,5174095056,47,3,125,119,244
285,5174095056,47,4,113,148,261
286,5174095056,47,5,133,106,239
287,5174095056,47,6,120,129,249
288,5174095184,48,1,118,122,240
289,5174095184,48,2,128,123,251
290,5174095184,48,3,136,113,249
291,5174095184,48,4,114,143,257
292,5174095184,48,5,122,128,250
293,5174095184,48,6,140,113,253
294,5174095312,49,1,119,125,244
295,5174095312,49,2,131,129,260
296,5174095312,49,3,146,113,259
297,5174095312,49,4,112,142,254
298,5174095312,49,5,121,117,238
299,5174095312,49,6,129,116,245
300,5174095440,50,1,121,135,256
301,5174095440,50,2,129,120,249
302,5174095440,50,3,131,120,251
303,5174095440,50,4,124,129,253
304,5174095440,50,5,135,114,249
305,5174095440,50,6,118,124,242
306,5174095568,51,1,121,135,256
307,5174095568,51,2,123,114,237
308,5174095568,51,3,137,126,263
309,5174095568,51,4,124,129,253
310,5174095568,51,5,135,114,249
311,5174095568,51,6,118,124,242
312,5176307856,52,1,126,136,262
313,5176307856,52,2,129,120,249
314,5176307856,52,3,131,120,251
315,5176307856,52,4,119,128,247
316,5176307856,52,5,135,114,249
317,5176307856,52,6,118,124,242
318,5176307984,53,1,123,127,250
319,5176307984,53,2,129,120,249
320,5176307984,53,3,131,120,251
321,5176307984,53,4,122,137,259
322,5176307984,53,5,135,114,249
323,5176307984,53,6,118,124,242
324,5176308240,54,1,124,134,258
325,5176308240,54,2,136,107,243
326,5176308240,54,3,111,130,241
327,5176308240,54,4,136,126,262
328,5176308240,54,5,118,128,246
329,5176308240,54,6,133,117,250
330,5176308368,55,1,121,125,246
331,5176308368,55,2,136,107,243
332,5176308368,55,3,111,130,241
333,5176308368,55,4,136,126,262
334,5176308368,55,5,121,137,258
335,5176308368,55,6,133,117,250
336,5176308624,56,1,136,113,249
337,5176308624,56,2,124,115,239
338,5176308624,56,3,130,132,262
339,5176308624,56,4,122,141,263
340,5176308624,56,5,112,130,242
341,5176308624,56,6,134,111,245
342,5176308752,57,1,135,127,262
343,5176308752,57,2,140,103,243
344,5176308752,57,3,116,141,257
345,5176308752,57,4,113,126,239
346,5176308752,57,5,118,130,248
347,5176308752,57,6,136,115,251
348,5176308880,58,1,127,110,237
349,5176308880,58,2,135,104,239
350,5176308880,58,3,119,141,260
351,5176308880,58,4,126,128,254
352,5176308880,58,5,121,131,252
353,5176308880,58,6,130,128,258
354,5176309008,59,1,134,119,253
355,5176309008,59,2,132,106,238
356,5176309008,59,3,112,132,244
357,5176309008,59,4,129,128,257
358,5176309008,59,5,121,131,252
359,5176309008,59,6,130,126,256
360,5176309136,60,1,121,118,239
361,5176309136,60,2,126,113,239
362,5176309136,60,3,133,114,247
363,5176309136,60,4,129,128,257
364,5176309136,60,5,123,135,258
365,5176309136,60,6,126,134,260
366,5176309264,61,1,113,126,239
367,5176309264,61,2,142,114,256
368,5176309264,61,3,136,124,260
369,5176309264,61,4,119,137,256
370,5176309264,61,5,118,126,244
371,5176309264,61,6,130,115,245
372,5176309392,62,1,117,127,244
373,5176309392,62,2,141,107,248
374,5176309392,62,3,133,119,252
375,5176309392,62,4,114,134,248
376,5176309392,62,5,121,135,256
377,5176309392,62,6,132,120,252
378,5176309520,63,1,129,129,258
379,5176309520,63,2,138,122,260
380,5176309520,63,3,137,104,241
381,5176309520,63,4,126,124,250
382,5176309520,63,5,109,138,247
383,5176309520,63,6,119,125,244
384,5176309648,64,1,129,129,258
385,5176309648,64,2,141,122,263
386,5176309648,64,3,134,104,238
387,5176309648,64,4,126,124,250
388,5176309648,64,5,109,138,247
389,5176309648,64,6,119,125,244
390,5176309776,65,1,130,112,242
391,5176309776,65,2,121,125,246
392,5176309776,65,3,111,144,255
393,5176309776,65,4,148,110,258
394,5176309776,65,5,123,125,248
395,5176309776,65,6,125,126,251
396,5176309904,66,1,130,112,242
397,5176309904,66,2,121,125,246
398,5176309904,66,3,108,135,243
399,5176309904,66,4,148,110,258
400,5176309904,66,5,126,134,260
401,5176309904,66,6,125,126,251
402,5176310032,67,1,138,122,260
403,5176310032,67,2,120,130,250
404,5176310032,67,3,117,126,243
405,5176310032,67,4,146,104,250
406,5176310032,67,5,120,133,253
407,5176310032,67,6,117,127,244
408,5176310160,68,1,131,113,244
409,5176310160,68,2,116,121,237
410,5176310160,68,3,132,122,254
411,5176310160,68,4,126,122,248
412,5176310160,68,5,125,136,261
413,5176310160,68,6,128,128,256
414,5176310288,69,1,115,123,238
415,5176310288,69,2,120,134,254
416,5176310288,69,3,134,113,247
417,5176310288,69,4,134,124,258
418,5176310288,69,5,112,130,242
419,5176310288,69,6,143,118,261
420,5176310416,70,1,115,123,238
421,5176310416,70,2,113,126,239
422,5176310416,70,3,141,121,262
423,5176310416,70,4,134,124,258
424,5176310416,70,5,112,130,242
425,5176310416,70,6,143,118,261
426,5176310672,71,1,128,128,256
427,5176310672,71,2,116,137,253
428,5176310672,71,3,137,122,259
429,5176310672,71,4,120,119,239
430,5176310672,71,5,116,130,246
431,5176310672,71,6,141,106,247
432,5176310800,72,1,117,127,244
433,5176310800,72,2,112,127,239
434,5176310800,72,3,142,119,261
435,5176310800,72,4,121,118,239
436,5176310800,72,5,114,140,254
437,5176310800,72,6,152,111,263
438,5176310928,73,1,119,126,245
439,5176310928,73,2,112,127,239
440,5176310928,73,3,130,108,238
441,5176310928,73,4,132,131,263
442,5176310928,73,5,114,140,254
443,5176310928,73,6,151,110,261
444,5176311056,74,1,122,125,247
445,5176311056,74,2,119,132,251
446,5176311056,74,3,126,122,248
447,5176311056,74,4,129,131,260
448,5176311056,74,5,121,123,244
449,5176311056,74,6,141,109,250
450,5176311184,75,1,131,126,257
451,5176311184,75,2,121,135,256
452,5176311184,75,3,119,120,239
453,5176311184,75,4,128,132,260
454,5176311184,75,5,119,119,238
455,5176311184,75,6,140,110,250
456,5176311312,76,1,125,118,243
457,5176311312,76,2,115,128,243
458,5176311312,76,3,134,128,262
459,5176311312,76,4,124,129,253
460,5176311312,76,5,123,127,250
461,5176311312,76,6,137,112,249
462,5176311440,77,1,124,120,244
463,5176311440,77,2,117,140,257
464,5176311440,77,3,128,130,258
465,5176311440,77,4,124,124,248
466,5176311440,77,5,118,122,240
467,5176311440,77,6,147,106,253
468,5176311568,78,1,124,132,256
469,5176311568,78,2,134,110,244
470,5176311568,78,3,127,120,247
471,5176311568,78,4,120,136,256
472,5176311568,78,5,139,104,243
473,5176311568,78,6,114,140,254
474,5176311696,79,1,122,128,250
475,5176311696,79,2,120,119,239
476,5176311696,79,3,125,116,241
477,5176311696,79,4,128,134,262
478,5176311696,79,5,145,105,250
479,5176311696,79,6,118,140,258
480,5178544208,80,1,112,132,244
481,5178544208,80,2,110,136,246
482,5178544208,80,3,125,125,250
483,5178544208,80,4,127,126,253
484,5178544208,80,5,142,111,253
485,5178544208,80,6,142,112,254
486,5178544336,81,1,113,126,239
487,5178544336,81,2,122,141,263
488,5178544336,81,3,131,121,252
489,5178544336,81,4,136,117,253
490,5178544336,81,5,114,132,246
491,5178544336,81,6,142,105,247
492,5178544464,82,1,113,126,239
493,5178544464,82,2,122,141,263
494,5178544464,82,3,123,114,237
495,5178544464,82,4,136,117,253
496,5178544464,82,5,122,139,261
497,5178544464,82,6,142,105,247
498,5178544592,83,1,126,133,259
499,5178544592,83,2,109,130,239
500,5178544592,83,3,133,129,262
501,5178544592,83,4,138,109,247
502,5178544592,83,5,117,120,237
503,5178544592,83,6,135,121,256
504,5178544720,84,1,121,118,239
505,5178544720,84,2,116,142,258
506,5178544720,84,3,128,132,260
507,5178544720,84,4,137,108,245
508,5178544720,84,5,118,126,244
509,5178544720,84,6,138,116,254
510,5178544848,85,1,134,121,255
511,5178544848,85,2,118,120,238
512,5178544848,85,3,134,129,263
513,5178544848,85,4,132,119,251
514,5178544848,85,5,119,133,252
515,5178544848,85,6,121,120,241
516,5178544976,86,1,127,120,247
517,5178544976,86,2,131,120,251
518,5178544976,86,3,122,128,250
519,5178544976,86,4,137,102,239
520,5178544976,86,5,128,123,251
521,5178544976,86,6,113,149,262
522,5178545104,87,1,136,114,250
523,5178545104,87,2,128,132,260
524,5178545104,87,3,123,117,240
525,5178545104,87,4,129,117,246
526,5178545104,87,5,122,128,250
527,5178545104,87,6,120,134,254
528,5178545232,88,1,133,118,251
529,5178545232,88,2,109,130,239
530,5178545232,88,3,129,128,257
531,5178545232,88,4,119,124,243
532,5178545232,88,5,135,114,249
533,5178545232,88,6,133,128,261
534,5178545360,89,1,125,128,253
535,5178545360,89,2,109,130,239
536,5178545360,89,3,136,115,251
537,5178545360,89,4,113,136,249
538,5178545360,89,5,137,110,247
539,5178545360,89,6,138,123,261
540,5178545488,90,1,129,128,257
541,5178545488,90,2,137,124,261
542,5178545488,90,3,124,126,250
543,5178545488,90,4,111,129,240
544,5178545488,90,5,134,103,237
545,5178545488,90,6,123,132,255
546,5178545616,91,1,116,127,243
547,5178545616,91,2,140,115,255
548,5178545616,91,3,143,106,249
549,5178545616,91,4,118,142,260
550,5178545616,91,5,124,119,243
551,5178545616,91,6,117,133,250
552,5178545744,92,1,116,127,243
553,5178545744,92,2,140,115,255
554,5178545744,92,3,143,106,249
555,5178545744,92,4,110,135,245
556,5178545744,92,5,132,126,258
557,5178545744,92,6,117,133,250
558,5178545872,93,1,113,126,239
559,5178545872,93,2,128,113,241
560,5178545872,93,3,145,110,255
561,5178545872,93,4,116,136,252
562,5178545872,93,5,139,124,263
563,5178545872,93,6,117,133,250
564,5178546000,94,1,119,126,245
565,5178546000,94,2,132,122,254
566,5178546000,94,3,143,109,252
567,5178546000,94,4,115,129,244
568,5178546000,94,5,125,122,247
569,5178546000,94,6,124,134,258
570,5178546128,95,1,119,126,245
571,5178546128,95,2,112,131,243
572,5178546128,95,3,143,106,249
573,5178546128,95,4,133,126,259
574,5178546128,95,5,123,130,253
575,5178546128,95,6,128,123,251
576,5178546256,96,1,113,126,239
577,5178546256,96,2,123,136,259
578,5178546256,96,3,143,102,245
579,5178546256,96,4,124,127,251
580,5178546256,96,5,122,128,250
581,5178546256,96,6,133,123,256
582,5178546384,97,1,113,126,239
583,5178546384,97,2,124,137,261
584,5178546384,97,3,141,103,244
585,5178546384,97,4,126,129,255
586,5178546384,97,5,121,124,245
587,5178546384,97,6,133,123,256
588,5178546512,98,1,113,126,239
589,5178546512,98,2,124,137,261
590,5178546512,98,3,139,98,237
591,5178546512,98,4,126,129,255
592,5178546512,98,5,121,124,245
593,5178546512,98,6,135,128,263
594,5178546640,99,1,113,126,239
595,5178546640,99,2,121,133,254
596,5178546640,99,3,148,112,260
597,5178546640,99,4,116,128,244
598,5178546640,99,5,127,121,248
599,5178546640,99,6,133,122,255
600,5178546896,100,1,113,133,246
601,5178546896,100,2,146,111,257
602,5178546896,100,3,124,120,244
603,5178546896,100,4,108,143,251
604,5178546896,100,5,143,119,262
605,5178546896,100,6,124,116,240
606,5178547024,101,1,123,127,250
607,5178547024,101,2,129,121,250
608,5178547024,101,3,141,109,250
609,5178547024,101,4,120,136,256
610,5178547024,101,5,125,132,257
611,5178547024,101,6,120,117,237
612,5178547152,102,1,140,121,261
613,5178547152,102,2,130,117,247
614,5178547152,102,3,131,113,244
615,5178547152,102,4,129,134,263
616,5178547152,102,5,119,126,245
617,5178547152,102,6,109,131,240
618,5178547280,103,1,141,117,258
619,5178547280,103,2,134,118,252
620,5178547280,103,3,115,130,245
621,5178547280,103,4,129,122,251
622,5178547280,103,5,123,128,251
623,5178547280,103,6,116,127,243
624,5178547408,104,1,133,114,247
625,5178547408,104,2,121,122,243
626,5178547408,104,3,121,140,261
627,5178547408,104,4,137,122,259
628,5178547408,104,5,122,126,248
629,5178547408,104,6,124,118,242
630,5178547536,105,1,130,131,261
631,5178547536,105,2,129,127,256
632,5178547536,105,3,127,114,241
633,5178547536,105,4,132,125,257
634,5178547536,105,5,124,123,247
635,5178547536,105,6,116,122,238
636,5178547664,106,1,126,137,263
637,5178547664,106,2,133,110,243
638,5178547664,106,3,136,118,254
639,5178547664,106,4,133,117,250
640,5178547664,106,5,117,130,247
641,5178547664,106,6,113,130,243
642,5178547792,107,1,126,137,263
643,5178547792,107,2,133,110,243
644,5178547792,107,3,136,118,254
645,5178547792,107,4,129,116,245
646,5178547792,107,5,117,130,247
647,5178547792,107,6,117,131,248
648,5178547920,108,1,117,124,241
649,5178547920,108,2,133,110,243
650,5178547920,108,3,136,118,254
651,5178547920,108,4,134,123,257
652,5178547920,108,5,117,130,247
653,5178547920,108,6,121,137,258
654,5178548048,109,1,113,137,250
655,5178548048,109,2,132,112,244
656,5178548048,109,3,140,115,255
657,5178548048,109,4,131,124,255
658,5178548048,109,5,122,136,258
659,5178548048,109,6,120,118,238
660,5178548176,110,1,113,137,250
661,5178548176,110,2,137,121,258
662,5178548176,110,3,140,115,255
663,5178548176,110,4,131,124,255
664,5178548176,110,5,117,127,244
665,5178548176,110,6,120,118,238
666,5180747920,111,1,114,140,254
667,5180747920,111,2,135,119,254
668,5180747920,111,3,136,121,257
669,5180747920,111,4,136,122,258
670,5180747920,111,5,118,119,237
671,5180747920,111,6,119,121,240
672,5180748048,112,1,126,137,263
673,5180748048,112,2,135,127,262
674,5180748048,112,3,126,121,247
675,5180748048,112,4,127,111,238
676,5180748048,112,5,130,114,244
677,5180748048,112,6,114,132,246
678,5180748176,113,1,132,128,260
679,5180748176,113,2,113,126,239
680,5180748176,113,3,125,119,244
681,5180748176,113,4,130,116,246
682,5180748176,113,5,146,111,257
683,5180748176,113,6,112,142,254
684,5180748304,114,1,126,136,262
685,5180748304,114,2,113,126,239
686,5180748304,114,3,136,122,258
687,5180748304,114,4,130,116,246
688,5180748304,114,5,141,105,246
689,5180748304,114,6,112,137,249
690,5180748432,115,1,126,117,243
691,5180748432,115,2,119,126,245
692,5180748432,115,3,124,115,239
693,5180748432,115,4,126,132,258
694,5180748432,115,5,144,109,253
695,5180748432,115,6,119,143,262
696,5180748560,116,1,121,131,252
697,5180748560,116,2,119,126,245
698,5180748560,116,3,132,111,243
699,5180748560,116,4,132,116,248
700,5180748560,116,5,138,111,249
701,5180748560,116,6,116,147,263
702,5180748816,117,1,134,120,254
703,5180748816,117,2,140,121,261
704,5180748816,117,3,113,133,246
705,5180748816,117,4,120,127,247
706,5180748816,117,5,138,104,242
707,5180748816,117,6,113,137,250
708,5180748944,118,1,134,120,254
709,5180748944,118,2,140,121,261
710,5180748944,118,3,113,133,246
711,5180748944,118,4,116,122,238
712,5180748944,118,5,143,115,258
713,5180748944,118,6,112,131,243
714,5180749072,119,1,138,121,259
715,5180749072,119,2,140,118,258
716,5180749072,119,3,115,131,246
717,5180749072,119,4,120,129,249
718,5180749072,119,5,131,111,242
719,5180749072,119,6,114,132,246
720,5180749200,120,1,145,117,262
721,5180749200,120,2,127,110,237
722,5180749200,120,3,123,139,262
723,5180749200,120,4,121,121,242
724,5180749200,120,5,136,115,251
725,5180749200,120,6,106,140,246
726,5180749328,121,1,143,108,251
727,5180749328,121,2,136,121,257
728,5180749328,121,3,113,126,239
729,5180749328,121,4,113,136,249
730,5180749328,121,5,129,126,255
731,5180749328,121,6,124,125,249
732,5180749584,122,1,138,103,241
733,5180749584,122,2,136,121,257
734,5180749584,122,3,118,131,249
735,5180749584,122,4,113,136,249
736,5180749584,122,5,129,126,255
737,5180749584,122,6,124,125,249
738,5180749712,123,1,137,112,249
739,5180749712,123,2,121,123,244
740,5180749712,123,3,139,111,250
741,5180749712,123,4,122,139,261
742,5180749712,123,5,121,135,256
743,5180749712,123,6,118,122,240
744,5180749840,124,1,127,124,251
745,5180749840,124,2,125,115,240
746,5180749840,124,3,137,122,259
747,5180749840,124,4,144,118,262
748,5180749840,124,5,114,134,248
749,5180749840,124,6,111,129,240
750,5180749968,125,1,127,124,251
751,5180749968,125,2,130,124,254
752,5180749968,125,3,132,113,245
753,5180749968,125,4,144,118,262
754,5180749968,125,5,114,134,248
755,5180749968,125,6,111,129,240
756,5180750224,126,1,122,131,253
757,5180750224,126,2,126,123,249
758,5180750224,126,3,138,104,242
759,5180750224,126,4,125,137,262
760,5180750224,126,5,110,127,237
761,5180750224,126,6,137,120,257
762,5180750352,127,1,134,107,241
763,5180750352,127,2,117,130,247
764,5180750352,127,3,144,119,263
765,5180750352,127,4,122,134,256
766,5180750352,127,5,121,127,248
767,5180750352,127,6,120,125,245
768,5180750480,128,1,134,107,241
769,5180750480,128,2,117,130,247
770,5180750480,128,3,135,106,241
771,5180750480,128,4,117,136,253
772,5180750480,128,5,129,134,263
773,5180750480,128,6,126,129,255
774,5180750608,129,1,132,114,246
775,5180750608,129,2,112,132,244
776,5180750608,129,3,147,106,253
777,5180750608,129,4,123,128,251
778,5180750608,129,5,122,126,248
779,5180750608,129,6,122,136,258
780,5180750736,130,1,130,129,259
781,5180750736,130,2,137,108,245
782,5180750736,130,3,126,122,248
783,5180750736,130,4,131,126,257
784,5180750736,130,5,125,127,252
785,5180750736,130,6,109,130,239
786,5180750864,131,1,121,118,239
787,5180750864,131,2,137,108,245
788,5180750864,131,3,131,124,255
789,5180750864,131,4,126,121,247
790,5180750864,131,5,126,131,257
791,5180750864,131,6,117,140,257
792,5180751120,132,1,147,107,254
793,5180751120,132,2,134,128,262
794,5180751120,132,3,120,117,237
795,5180751120,132,4,128,128,256
796,5180751120,132,5,117,127,244
797,5180751120,132,6,112,135,247
798,5180751248,133,1,147,107,254
799,5180751248,133,2,134,128,262
800,5180751248,133,3,127,126,253
801,5180751248,133,4,121,119,240
802,5180751248,133,5,117,127,244
803,5180751248,133,6,112,135,247
804,5180751376,134,1,147,107,254
805,5180751376,134,2,134,128,262
806,5180751376,134,3,129,126,255
807,5180751376,134,4,119,119,238
808,5180751376,134,5,117,127,244
809,5180751376,134,6,112,135,247
810,5180751504,135,1,134,106,240
811,5180751504,135,2,126,120,246
812,5180751504,135,3,133,130,263
813,5180751504,135,4,121,122,243
814,5180751504,135,5,122,125,247
815,5180751504,135,6,122,139,261
816,5180751632,136,1,133,113,246
817,5180751632,136,2,114,128,242
818,5180751632,136,3,123,140,263
819,5180751632,136,4,126,112,238
820,5180751632,136,5,145,111,256
821,5180751632,136,6,117,138,255
822,5180751760,137,1,134,114,248
823,5180751760,137,2,122,137,259
824,5180751760,137,3,122,128,250
825,5180751760,137,4,129,128,257
826,5180751760,137,5,134,108,242
827,5180751760,137,6,117,127,244
828,5182988368,138,1,130,131,261
829,5182988368,138,2,124,129,253
830,5182988368,138,3,113,127,240
831,5182988368,138,4,125,118,243
832,5182988368,138,5,126,124,250
833,5182988368,138,6,140,113,253
834,5182988496,139,1,117,138,255
835,5182988496,139,2,123,117,240
836,5182988496,139,3,126,123,249
837,5182988496,139,4,128,135,263
838,5182988496,139,5,123,114,237
839,5182988496,139,6,141,115,256
840,5182988624,140,1,117,138,255
841,5182988624,140,2,123,117,240
842,5182988624,140,3,124,123,247
843,5182988624,140,4,128,135,263
844,5182988624,140,5,125,114,239
845,5182988624,140,6,141,115,256
846,5182988752,141,1,117,138,255
847,5182988752,141,2,133,129,262
848,5182988752,141,3,124,123,247
849,5182988752,141,4,118,123,241
850,5182988752,141,5,125,114,239
851,5182988752,141,6,141,115,256
852,5182988880,142,1,122,141,263
853,5182988880,142,2,120,125,245
854,5182988880,142,3,118,124,242
855,5182988880,142,4,114,128,242
856,5182988880,142,5,136,111,247
857,5182988880,142,6,148,113,261
858,5182989008,143,1,112,130,242
859,5182989008,143,2,120,125,245
860,5182989008,143,3,128,135,263
861,5182989008,143,4,114,128,242
862,5182989008,143,5,136,111,247
863,5182989008,143,6,148,113,261
864,5182989136,144,1,135,118,253
865,5182989136,144,2,121,123,244
866,5182989136,144,3,113,140,253
867,5182989136,144,4,123,139,262
868,5182989136,144,5,141,105,246
869,5182989136,144,6,125,117,242
870,5182989264,145,1,129,117,246
871,5182989264,145,2,121,123,244
872,5182989264,145,3,113,140,253
873,5182989264,145,4,123,139,262
874,5182989264,145,5,147,106,253
875,5182989264,145,6,125,117,242
876,5182989392,146,1,132,126,258
877,5182989392,146,2,121,123,244
878,5182989392,146,3,110,131,241
879,5182989392,146,4,111,133,244
880,5182989392,146,5,147,106,253
881,5182989392,146,6,137,123,260
882,5182989520,147,1,129,117,246
883,5182989520,147,2,121,123,244
884,5182989520,147,3,113,140,253
885,5182989520,147,4,111,133,244
886,5182989520,147,5,147,106,253
887,5182989520,147,6,137,123,260
888,5182989648,148,1,149,112,261
889,5182989648,148,2,120,128,248
890,5182989648,148,3,122,134,256
891,5182989648,148,4,115,131,246
892,5182989648,148,5,121,124,245
893,5182989648,148,6,131,113,244
894,5182989776,149,1,130,116,246
895,5182989776,149,2,146,108,254
896,5182989776,149,3,112,137,249
897,5182989776,149,4,121,129,250
898,5182989776,149,5,119,127,246
899,5182989776,149,6,130,125,255
900,5182989904,150,1,134,120,254
901,5182989904,150,2,143,105,248
902,5182989904,150,3,111,136,247
903,5182989904,150,4,128,135,263
904,5182989904,150,5,119,127,246
905,5182989904,150,6,123,119,242
906,5182990032,151,1,145,116,261
907,5182990032,151,2,124,123,247
908,5182990032,151,3,108,135,243
909,5182990032,151,4,131,106,237
910,5182990032,151,5,124,134,258
911,5182990032,151,6,126,128,254
912,5182990160,152,1,117,127,244
913,5182990160,152,2,140,122,262
914,5182990160,152,3,115,131,246
915,5182990160,152,4,125,130,255
916,5182990160,152,5,142,111,253
917,5182990160,152,6,119,121,240
918,5182990288,153,1,117,127,244
919,5182990288,153,2,140,122,262
920,5182990288,153,3,115,131,246
921,5182990288,153,4,115,123,238
922,5182990288,153,5,142,111,253
923,5182990288,153,6,129,128,257
924,5182990416,154,1,139,117,256
925,5182990416,154,2,122,141,263
926,5182990416,154,3,122,134,256
927,5182990416,154,4,129,111,240
928,5182990416,154,5,135,107,242
929,5182990416,154,6,111,132,243
930,5182990544,155,1,139,117,256
931,5182990544,155,2,122,141,263
932,5182990544,155,3,115,122,237
933,5182990544,155,4,136,123,259
934,5182990544,155,5,135,107,242
935,5182990544,155,6,111,132,243
936,5182990672,156,1,146,112,258
937,5182990672,156,2,113,126,239
938,5182990672,156,3,116,142,258
939,5182990672,156,4,130,121,251
940,5182990672,156,5,137,119,256
941,5182990672,156,6,116,122,238
942,5182990800,157,1,146,112,258
943,5182990800,157,2,113,126,239
944,5182990800,157,3,116,142,258
945,5182990800,157,4,130,121,251
946,5182990800,157,5,127,112,239
947,5182990800,157,6,126,129,255
948,5182990928,158,1,141,109,250
949,5182990928,158,2,113,126,239
950,5182990928,158,3,117,140,257
951,5182990928,158,4,139,123,262
952,5182990928,158,5,119,121,240
953,5182990928,158,6,129,123,252
954,5182991056,159,1,143,118,261
955,5182991056,159,2,117,130,247
956,5182991056,159,3,121,135,256
957,5182991056,159,4,130,113,243
958,5182991056,159,5,126,113,239
959,5182991056,159,6,121,133,254
960,5182991184,160,1,115,133,248
961,5182991184,160,2,128,135,263
962,5182991184,160,3,134,110,244
963,5182991184,160,4,125,117,242
964,5182991184,160,5,146,110,256
965,5182991184,160,6,110,137,247
966,5182991312,161,1,123,140,263
967,5182991312,161,2,113,126,239
968,5182991312,161,3,138,106,244
969,5182991312,161,4,123,122,245
970,5182991312,161,5,140,111,251
971,5182991312,161,6,121,137,258
972,5182991440,162,1,114,132,246
973,5182991440,162,2,113,126,239
974,5182991440,162,3,147,114,261
975,5182991440,162,4,123,122,245
976,5182991440,162,5,140,111,251
977,5182991440,162,6,121,137,258
978,5182991568,163,1,122,138,260
979,5182991568,163,2,133,117,250
980,5182991568,163,3,129,132,261
981,5182991568,163,4,123,118,241
982,5182991568,163,5,136,103,239
983,5182991568,163,6,115,134,249
984,5182991696,164,1,118,144,262
985,5182991696,164,2,140,109,249
986,5182991696,164,3,140,114,254
987,5182991696,164,4,119,127,246
988,5182991696,164,5,125,119,244
989,5182991696,164,6,116,129,245
990,5182991824,165,1,118,144,262
991,5182991824,165,2,138,111,249
992,5182991824,165,3,142,112,254
993,5182991824,165,4,119,127,246
994,5182991824,165,5,125,119,244
995,5182991824,165,6,116,129,245
996,5182991952,166,1,118,138,256
997,5182991952,166,2,130,123,253
998,5182991952,166,3,125,128,253
999,5182991952,166,4,115,123,238
1000,5182991952,166,5,123,119,242
1001,5182991952,166,6,147,111,258
1002,5182992080,167,1,113,137,250
1003,5182992080,167,2,139,103,242
1004,5182992080,167,3,123,127,250
1005,5182992080,167,4,122,131,253
1006,5182992080,167,5,134,127,261
1007,5182992080,167,6,127,117,244
1008,5182992336,168,1,146,107,253
1009,5182992336,168,2,118,140,258
1010,5182992336,168,3,116,122,238
1011,5182992336,168,4,126,116,242
1012,5182992336,168,5,122,131,253
1013,5182992336,168,6,130,126,256
1014,5185208464,169,1,111,133,244
1015,5185208464,169,2,128,132,260
1016,5185208464,169,3,128,125,253
1017,5185208464,169,4,141,108,249
1018,5185208464,169,5,138,114,252
1019,5185208464,169,6,112,130,242
1020,5185208720,170,1,119,126,245
1021,5185208720,170,2,126,137,263
1022,5185208720,170,3,133,115,248
1023,5185208720,170,4,137,106,243
1024,5185208720,170,5,129,126,255
1025,5185208720,170,6,114,132,246
1026,5185208848,171,1,116,134,250
1027,5185208848,171,2,114,133,247
1028,5185208848,171,3,117,137,254
1029,5185208848,171,4,136,109,245
1030,5185208848,171,5,142,118,260
1031,5185208848,171,6,133,111,244
1032,5185208976,172,1,116,134,250
1033,5185208976,172,2,114,133,247
1034,5185208976,172,3,112,126,238
1035,5185208976,172,4,141,120,261
1036,5185208976,172,5,142,118,260
1037,5185208976,172,6,133,111,244
1038,5185209232,173,1,116,134,250
1039,5185209232,173,2,114,133,247
1040,5185209232,173,3,122,133,255
1041,5185209232,173,4,131,113,244
1042,5185209232,173,5,142,118,260
1043,5185209232,173,6,133,111,244
1044,5185209360,174,1,123,128,251
1045,5185209360,174,2,133,129,262
1046,5185209360,174,3,120,122,242
1047,5185209360,174,4,134,116,250
1048,5185209360,174,5,126,114,240
1049,5185209360,174,6,122,133,255
1050,5185209488,175,1,122,125,247
1051,5185209488,175,2,118,139,257
1052,5185209488,175,3,120,127,247
1053,5185209488,175,4,129,113,242
1054,5185209488,175,5,127,117,244
1055,5185209488,175,6,142,121,263
1056,5185209616,176,1,122,125,247
1057,5185209616,176,2,120,139,259
1058,5185209616,176,3,128,119,247
1059,5185209616,176,4,128,120,248
1060,5185209616,176,5,131,129,260
1061,5185209616,176,6,129,110,239
1062,5185209744,177,1,122,125,247
1063,5185209744,177,2,117,138,255
1064,5185209744,177,3,126,118,244
1065,5185209744,177,4,130,121,251
1066,5185209744,177,5,124,119,243
1067,5185209744,177,6,139,121,260
1068,5185209872,178,1,122,125,247
1069,5185209872,178,2,118,139,257
1070,5185209872,178,3,126,118,244
1071,5185209872,178,4,130,121,251
1072,5185209872,178,5,124,119,243
1073,5185209872,178,6,138,120,258
1074,5185210000,179,1,113,126,239
1075,5185210000,179,2,129,129,258
1076,5185210000,179,3,116,132,248
1077,5185210000,179,4,131,106,237
1078,5185210000,179,5,137,119,256
1079,5185210000,179,6,132,130,262
1080,5185210128,180,1,117,127,244
1081,5185210128,180,2,118,139,257
1082,5185210128,180,3,137,109,246
1083,5185210128,180,4,114,137,251
1084,5185210128,180,5,132,115,247
1085,5185210128,180,6,140,115,255
1086,5185210256,181,1,133,123,256
1087,5185210256,181,2,137,117,254
1088,5185210256,181,3,135,113,248
1089,5185210256,181,4,118,123,241
1090,5185210256,181,5,117,127,244
1091,5185210256,181,6,118,139,257
1092,5185210384,182,1,126,128,254
1093,5185210384,182,2,133,113,246
1094,5185210384,182,3,129,115,244
1095,5185210384,182,4,129,131,260
1096,5185210384,182,5,119,126,245
1097,5185210384,182,6,122,129,251
1098,5185210512,183,1,133,125,258
1099,5185210512,183,2,120,131,251
1100,5185210512,183,3,130,120,250
1101,5185210512,183,4,123,126,249
1102,5185210512,183,5,123,120,243
1103,5185210512,183,6,129,120,249
1104,5185210640,184,1,129,129,258
1105,5185210640,184,2,131,111,242
1106,5185210640,184,3,136,119,255
1107,5185210640,184,4,115,123,238
1108,5185210640,184,5,132,129,261
1109,5185210640,184,6,115,131,246
1110,5185210768,185,1,129,129,258
1111,5185210768,185,2,131,111,242
1112,5185210768,185,3,128,112,240
1113,5185210768,185,4,123,130,253
1114,5185210768,185,5,132,129,261
1115,5185210768,185,6,115,131,246
1116,5185210896,186,1,129,129,258
1117,5185210896,186,2,131,111,242
1118,5185210896,186,3,134,118,252
1119,5185210896,186,4,117,124,241
1120,5185210896,186,5,132,129,261
1121,5185210896,186,6,115,131,246
1122,5185211152,187,1,113,126,239
1123,5185211152,187,2,134,112,246
1124,5185211152,187,3,113,149,262
1125,5185211152,187,4,123,124,247
1126,5185211152,187,5,145,116,261
1127,5185211152,187,6,130,115,245
1128,5185211280,188,1,113,126,239
1129,5185211280,188,2,134,112,246
1130,5185211280,188,3,110,140,250
1131,5185211280,188,4,123,124,247
1132,5185211280,188,5,145,116,261
1133,5185211280,188,6,133,124,257
1134,5185211408,189,1,122,127,249
1135,5185211408,189,2,138,120,258
1136,5185211408,189,3,124,128,252
1137,5185211408,189,4,128,121,249
1138,5185211408,189,5,136,118,254
1139,5185211408,189,6,110,128,238
1140,5185211536,190,1,128,116,244
1141,5185211536,190,2,138,120,258
1142,5185211536,190,3,122,120,242
1143,5185211536,190,4,129,131,260
1144,5185211536,190,5,123,116,239
1145,5185211536,190,6,118,139,257
1146,5185211664,191,1,138,122,260
1147,5185211664,191,2,136,111,247
1148,5185211664,191,3,113,140,253
1149,5185211664,191,4,126,131,257
1150,5185211664,191,5,114,128,242
1151,5185211664,191,6,131,110,241
1152,5185211792,192,1,123,118,241
1153,5185211792,192,2,131,108,239
1154,5185211792,192,3,113,140,253
1155,5185211792,192,4,126,131,257
1156,5185211792,192,5,126,131,257
1157,5185211792,192,6,139,114,253
1158,5185211920,193,1,129,121,250
1159,5185211920,193,2,142,107,249
1160,5185211920,193,3,118,133,251
1161,5185211920,193,4,126,115,241
1162,5185211920,193,5,122,131,253
1163,5185211920,193,6,121,135,256
1164,5185212048,194,1,129,121,250
1165,5185212048,194,2,142,107,249
1166,5185212048,194,3,120,134,254
1167,5185212048,194,4,124,114,238
1168,5185212048,194,5,122,131,253
1169,5185212048,194,6,121,135,256
1170,5185212176,195,1,132,121,253
1171,5185212176,195,2,141,109,250
1172,5185212176,195,3,120,134,254
1173,5185212176,195,4,127,119,246
1174,5185212176,195,5,117,126,243
1175,5185212176,195,6,121,133,254
1176,5187440720,196,1,137,123,260
1177,5187440720,196,2,144,108,252
1178,5187440720,196,3,123,131,254
1179,5187440720,196,4,122,123,245
1180,5187440720,196,5,114,128,242
1181,5187440720,196,6,118,129,247
1182,5187440848,197,1,113,126,239
1183,5187440848,197,2,137,112,249
1184,5187440848,197,3,121,118,239
1185,5187440848,197,4,139,122,261
1186,5187440848,197,5,134,123,257
1187,5187440848,197,6,114,141,255
1188,5187440976,198,1,135,119,254
1189,5187440976,198,2,126,133,259
1190,5187440976,198,3,125,124,249
1191,5187440976,198,4,120,118,238
1192,5187440976,198,5,130,110,240
1193,5187440976,198,6,122,138,260
1194,5187441104,199,1,135,119,254
1195,5187441104,199,2,126,133,259
1196,5187441104,199,3,125,124,249
1197,5187441104,199,4,120,118,238
1198,5187441104,199,5,130,109,239
1199,5187441104,199,6,122,139,261
1200,5187441232,200,1,132,122,254
1201,5187441232,200,2,126,119,245
1202,5187441232,200,3,113,133,246
1203,5187441232,200,4,126,120,246
1204,5187441232,200,5,146,112,258
1205,5187441232,200,6,115,136,251
1206,5187441488,201,1,124,131,255
1207,5187441488,201,2,127,119,246
1208,5187441488,201,3,120,123,243
1209,5187441488,201,4,126,120,246
1210,5187441488,201,5,148,112,260
1211,5187441488,201,6,113,137,250
1212,5187441616,202,1,123,129,252
1213,5187441616,202,2,130,125,255
1214,5187441616,202,3,119,125,244
1215,5187441616,202,4,134,121,255
1216,5187441616,202,5,139,105,244
1217,5187441616,202,6,113,137,250
1218,5187441744,203,1,135,124,259
1219,5187441744,203,2,110,127,237
1220,5187441744,203,3,120,138,258
1221,5187441744,203,4,129,122,251
1222,5187441744,203,5,147,110,257
1223,5187441744,203,6,117,121,238
1224,5187441872,204,1,135,124,259
1225,5187441872,204,2,110,127,237
1226,5187441872,204,3,116,126,242
1227,5187441872,204,4,129,122,251
1228,5187441872,204,5,147,110,257
1229,5187441872,204,6,121,133,254
1230,5187442000,205,1,140,118,258
1231,5187442000,205,2,113,132,245
1232,5187442000,205,3,118,134,252
1233,5187442000,205,4,122,128,250
1234,5187442000,205,5,140,113,253
1235,5187442000,205,6,125,117,242
1236,5187442128,206,1,140,118,258
1237,5187442128,206,2,113,132,245
1238,5187442128,206,3,115,136,251
1239,5187442128,206,4,122,128,250
1240,5187442128,206,5,143,111,254
1241,5187442128,206,6,125,117,242
1242,5187442256,207,1,127,124,251
1243,5187442256,207,2,138,118,256
1244,5187442256,207,3,115,130,245
1245,5187442256,207,4,129,128,257
1246,5187442256,207,5,113,128,241
1247,5187442256,207,6,136,114,250
1248,5187442384,208,1,127,114,241
1249,5187442384,208,2,134,120,254
1250,5187442384,208,3,122,137,259
1251,5187442384,208,4,122,128,250
1252,5187442384,208,5,112,130,242
1253,5187442384,208,6,141,113,254
1254,5187442512,209,1,134,124,258
1255,5187442512,209,2,126,113,239
1256,5187442512,209,3,121,131,252
1257,5187442512,209,4,122,128,250
1258,5187442512,209,5,114,133,247
1259,5187442512,209,6,141,113,254
1260,5187442640,210,1,126,134,260
1261,5187442640,210,2,115,129,244
1262,5187442640,210,3,116,122,238
1263,5187442640,210,4,126,116,242
1264,5187442640,210,5,145,114,259
1265,5187442640,210,6,130,127,257
1266,5187442768,211,1,116,130,246
1267,5187442768,211,2,116,139,255
1268,5187442768,211,3,118,124,242
1269,5187442768,211,4,132,117,249
1270,5187442768,211,5,141,114,255
1271,5187442768,211,6,135,118,253
1272,5187442896,212,1,119,127,246
1273,5187442896,212,2,114,123,237
1274,5187442896,212,3,128,133,261
1275,5187442896,212,4,147,108,255
1276,5187442896,212,5,130,120,250
1277,5187442896,212,6,120,131,251
1278,5187443024,213,1,119,127,246
1279,5187443024,213,2,118,130,248
1280,5187443024,213,3,124,126,250
1281,5187443024,213,4,147,108,255
1282,5187443024,213,5,130,120,250
1283,5187443024,213,6,120,131,251
1284,5187443152,214,1,142,103,245
1285,5187443152,214,2,111,141,252
1286,5187443152,214,3,141,122,263
1287,5187443152,214,4,136,120,256
1288,5187443152,214,5,116,125,241
1289,5187443152,214,6,112,131,243
1290,5187443408,215,1,141,114,255
1291,5187443408,215,2,120,138,258
1292,5187443408,215,3,129,112,241
1293,5187443408,215,4,125,115,240
1294,5187443408,215,5,118,131,249
1295,5187443408,215,6,125,132,257
1296,5187443536,216,1,133,104,237
1297,5187443536,216,2,114,136,250
1298,5187443536,216,3,128,121,249
1299,5187443536,216,4,122,137,259
1300,5187443536,216,5,140,122,262
1301,5187443536,216,6,121,122,243
1302,5187443664,217,1,136,103,239
1303,5187443664,217,2,119,134,253
1304,5187443664,217,3,128,114,242
1305,5187443664,217,4,123,139,262
1306,5187443664,217,5,133,118,251
1307,5187443664,217,6,119,134,253
1308,5187443792,218,1,136,103,239
1309,5187443792,218,2,113,128,241
1310,5187443792,218,3,134,120,254
1311,5187443792,218,4,123,139,262
1312,5187443792,218,5,133,118,251
1313,5187443792,218,6,119,134,253
1314,5187443920,219,1,137,126,263
1315,5187443920,219,2,121,119,240
1316,5187443920,219,3,128,134,262
1317,5187443920,219,4,131,113,244
1318,5187443920,219,5,124,117,241
1319,5187443920,219,6,117,133,250
1320,5187444048,220,1,123,119,242
1321,5187444048,220,2,130,125,255
1322,5187444048,220,3,128,134,262
1323,5187444048,220,4,131,113,244
1324,5187444048,220,5,124,117,241
1325,5187444048,220,6,122,134,256
1326,5187444176,221,1,125,116,241
1327,5187444176,221,2,121,119,240
1328,5187444176,221,3,132,127,259
1329,5187444176,221,4,123,128,251
1330,5187444176,221,5,125,128,253
1331,5187444176,221,6,132,124,256
1332,5187444432,222,1,124,117,241
1333,5187444432,222,2,121,119,240
1334,5187444432,222,3,133,126,259
1335,5187444432,222,4,123,128,251
1336,5187444432,222,5,125,128,253
1337,5187444432,222,6,132,124,256
1338,5187444560,223,1,147,112,259
1339,5187444560,223,2,122,133,255
1340,5187444560,223,3,111,132,243
1341,5187444560,223,4,133,112,245
1342,5187444560,223,5,125,128,253
1343,5187444560,223,6,120,125,245
1344,5187444688,224,1,118,125,243
1345,5187444688,224,2,120,119,239
1346,5187444688,224,3,129,131,260
1347,5187444688,224,4,146,103,249
1348,5187444688,224,5,126,130,256
1349,5187444688,224,6,119,134,253
1350,5189648528,225,1,122,134,256
1351,5189648528,225,2,120,119,239
1352,5189648528,225,3,125,122,247
1353,5189648528,225,4,146,103,249
1354,5189648528,225,5,126,130,256
1355,5189648528,225,6,119,134,253
1356,5189648656,226,1,119,123,242
1357,5189648656,226,2,120,119,239
1358,5189648656,226,3,128,133,261
1359,5189648656,226,4,146,103,249
1360,5189648656,226,5,126,130,256
1361,5189648656,226,6,119,134,253
1362,5189648784,227,1,129,132,261
1363,5189648784,227,2,120,119,239
1364,5189648784,227,3,128,133,261
1365,5189648784,227,4,146,103,249
1366,5189648784,227,5,116,121,237
1367,5189648784,227,6,119,134,253
1368,5189648912,228,1,124,129,253
1369,5189648912,228,2,144,108,252
1370,5189648912,228,3,135,122,257
1371,5189648912,228,4,113,132,245
1372,5189648912,228,5,125,113,238
1373,5189648912,228,6,117,138,255
1374,5189649040,229,1,129,133,262
1375,5189649040,229,2,135,103,238
1376,5189649040,229,3,115,133,248
1377,5189649040,229,4,132,122,254
1378,5189649040,229,5,132,129,261
1379,5189649040,229,6,115,122,237
1380,5189649168,230,1,116,130,246
1381,5189649168,230,2,140,109,249
1382,5189649168,230,3,115,133,248
1383,5189649168,230,4,133,119,252
1384,5189649168,230,5,128,115,243
1385,5189649168,230,6,126,136,262
1386,5189649296,231,1,116,134,250
1387,5189649296,231,2,124,130,254
1388,5189649296,231,3,125,125,250
1389,5189649296,231,4,136,103,239
1390,5189649296,231,5,138,109,247
1391,5189649296,231,6,119,141,260
1392,5189649424,232,1,116,124,240
1393,5189649424,232,2,130,125,255
1394,5189649424,232,3,124,132,256
1395,5189649424,232,4,145,112,257
1396,5189649424,232,5,130,118,248
1397,5189649424,232,6,113,131,244
1398,5189649552,233,1,125,136,261
1399,5189649552,233,2,125,123,248
1400,5189649552,233,3,119,125,244
1401,5189649552,233,4,145,112,257
1402,5189649552,233,5,131,115,246
1403,5189649552,233,6,113,131,244
1404,5189649680,234,1,135,126,261
1405,5189649680,234,2,131,108,239
1406,5189649680,234,3,119,123,242
1407,5189649680,234,4,129,125,254
1408,5189649680,234,5,129,132,261
1409,5189649680,234,6,115,128,243
1410,5189649808,235,1,133,117,250
1411,5189649808,235,2,138,121,259
1412,5189649808,235,3,130,109,239
1413,5189649808,235,4,118,120,238
1414,5189649808,235,5,123,128,251
1415,5189649808,235,6,116,147,263
1416,5189649936,236,1,135,125,260
1417,5189649936,236,2,137,118,255
1418,5189649936,236,3,126,113,239
1419,5189649936,236,4,116,132,248
1420,5189649936,236,5,123,130,253
1421,5189649936,236,6,121,124,245
1422,5189650064,237,1,117,123,240
1423,5189650064,237,2,133,109,242
1424,5189650064,237,3,134,117,251
1425,5189650064,237,4,128,130,258
1426,5189650064,237,5,120,129,249
1427,5189650064,237,6,126,134,260
1428,5189650192,238,1,132,120,252
1429,5189650192,238,2,131,108,239
1430,5189650192,238,3,108,130,238
1431,5189650192,238,4,124,128,252
1432,5189650192,238,5,126,133,259
1433,5189650192,238,6,137,123,260
1434,5189650320,239,1,133,110,243
1435,5189650320,239,2,125,127,252
1436,5189650320,239,3,121,124,245
1437,5189650320,239,4,139,101,240
1438,5189650320,239,5,123,139,262
1439,5189650320,239,6,117,141,258
1440,5189650448,240,1,126,120,246
1441,5189650448,240,2,135,119,254
1442,5189650448,240,3,111,132,243
1443,5189650448,240,4,139,103,242
1444,5189650448,240,5,130,129,259
1445,5189650448,240,6,117,139,256
1446,5189650832,241,1,130,110,240
1447,5189650832,241,2,137,109,246
1448,5189650832,241,3,129,134,263
1449,5189650832,241,4,110,138,248
1450,5189650832,241,5,133,115,248
1451,5189650832,241,6,119,136,255
1452,5189650960,242,1,110,132,242
1453,5189650960,242,2,127,116,243
1454,5189650960,242,3,141,121,262
1455,5189650960,242,4,121,130,251
1456,5189650960,242,5,123,128,251
1457,5189650960,242,6,136,115,251
1458,5189651088,243,1,136,125,261
1459,5189651088,243,2,117,139,256
1460,5189651088,243,3,138,108,246
1461,5189651088,243,4,120,120,240
1462,5189651088,243,5,120,129,249
1463,5189651088,243,6,127,121,248
1464,5189651216,244,1,104,135,239
1465,5189651216,244,2,128,113,241
1466,5189651216,244,3,139,124,263
1467,5189651216,244,4,129,122,251
1468,5189651216,244,5,137,123,260
1469,5189651216,244,6,121,125,246
1470,5189651344,245,1,122,124,246
1471,5189651344,245,2,126,125,251
1472,5189651344,245,3,141,114,255
1473,5189651344,245,4,131,121,252
1474,5189651344,245,5,117,127,244
1475,5189651344,245,6,121,131,252
1476,5189651472,246,1,129,119,248
1477,5189651472,246,2,120,139,259
1478,5189651472,246,3,122,121,243
1479,5189651472,246,4,123,119,242
1480,5189651472,246,5,119,126,245
1481,5189651472,246,6,145,118,263
1482,5189651600,247,1,124,126,250
1483,5189651600,247,2,123,120,243
1484,5189651600,247,3,118,128,246
1485,5189651600,247,4,116,131,247
1486,5189651600,247,5,132,122,254
1487,5189651600,247,6,145,115,260
1488,5189651728,248,1,132,129,261
1489,5189651728,248,2,115,124,239
1490,5189651728,248,3,124,129,253
1491,5189651728,248,4,122,138,260
1492,5189651728,248,5,125,118,243
1493,5189651728,248,6,140,104,244
1494,5189651984,249,1,112,126,238
1495,5189651984,249,2,144,119,263
1496,5189651984,249,3,141,122,263
1497,5189651984,249,4,133,119,252
1498,5189651984,249,5,113,126,239
1499,5189651984,249,6,115,130,245
1500,5189652112,250,1,129,125,254
1501,5189652112,250,2,134,126,260
1502,5189652112,250,3,130,107,237
1503,5189652112,250,4,115,130,245
1504,5189652112,250,5,125,128,253
1505,5189652112,250,6,125,126,251
1506,5189652240,251,1,122,137,259
1507,5189652240,251,2,144,112,256
1508,5189652240,251,3,119,125,244
1509,5189652240,251,4,126,119,245
1510,5189652240,251,5,134,123,257
1511,5189652240,251,6,113,126,239
1512,5189652368,252,1,114,130,244
1513,5189652368,252,2,145,114,259
1514,5189652368,252,3,130,127,257
1515,5189652368,252,4,133,127,260
1516,5189652368,252,5,123,118,241
1517,5189652368,252,6,113,126,239
1518,5191884880,253,1,116,141,257
1519,5191884880,253,2,116,125,241
1520,5191884880,253,3,136,123,259
1521,5191884880,253,4,147,108,255
1522,5191884880,253,5,116,130,246
1523,5191884880,253,6,127,115,242
1524,5191885008,254,1,122,129,251
1525,5191885008,254,2,112,130,242
1526,5191885008,254,3,132,118,250
1527,5191885008,254,4,142,120,262
1528,5191885008,254,5,126,122,248
1529,5191885008,254,6,124,123,247
1530,5191885136,255,1,117,122,239
1531,5191885136,255,2,112,130,242
1532,5191885136,255,3,137,125,262
1533,5191885136,255,4,142,120,262
1534,5191885136,255,5,126,122,248
1535,5191885136,255,6,124,123,247
1536,5191885264,256,1,122,134,256
1537,5191885264,256,2,117,133,250
1538,5191885264,256,3,134,123,257
1539,5191885264,256,4,138,101,239
1540,5191885264,256,5,118,123,241
1541,5191885264,256,6,129,128,257
1542,5191885392,257,1,122,138,260
1543,5191885392,257,2,117,131,248
1544,5191885392,257,3,128,119,247
1545,5191885392,257,4,140,102,242
1546,5191885392,257,5,130,129,259
1547,5191885392,257,6,121,123,244
1548,5191885520,258,1,113,138,251
1549,5191885520,258,2,117,123,240
1550,5191885520,258,3,126,123,249
1551,5191885520,258,4,145,118,263
1552,5191885520,258,5,129,128,257
1553,5191885520,258,6,128,112,240
1554,5191885648,259,1,114,123,237
1555,5191885648,259,2,116,142,258
1556,5191885648,259,3,128,127,255
1557,5191885648,259,4,138,104,242
1558,5191885648,259,5,130,131,261
1559,5191885648,259,6,132,115,247
1560,5191885776,260,1,131,117,248
1561,5191885776,260,2,123,135,258
1562,5191885776,260,3,117,127,244
1563,5191885776,260,4,133,115,248
1564,5191885776,260,5,122,132,254
1565,5191885776,260,6,132,116,248
1566,5191885904,261,1,131,117,248
1567,5191885904,261,2,123,135,258
1568,5191885904,261,3,117,127,244
1569,5191885904,261,4,133,115,248
1570,5191885904,261,5,125,133,258
1571,5191885904,261,6,129,115,244
1572,5191886032,262,1,125,114,239
1573,5191886032,262,2,125,136,261
1574,5191886032,262,3,123,130,253
1575,5191886032,262,4,131,114,245
1576,5191886032,262,5,125,133,258
1577,5191886032,262,6,129,115,244
1578,5191886160,263,1,129,123,252
1579,5191886160,263,2,125,136,261
1580,5191886160,263,3,119,121,240
1581,5191886160,263,4,131,114,245
1582,5191886160,263,5,125,133,258
1583,5191886160,263,6,129,115,244
1584,5191886416,264,1,119,124,243
1585,5191886416,264,2,132,118,250
1586,5191886416,264,3,136,105,241
1587,5191886416,264,4,115,135,250
1588,5191886416,264,5,123,130,253
1589,5191886416,264,6,133,130,263
1590,5191886544,265,1,134,118,252
1591,5191886544,265,2,137,111,248
1592,5191886544,265,3,115,124,239
1593,5191886544,265,4,112,135,247
1594,5191886544,265,5,126,129,255
1595,5191886544,265,6,134,125,259
1596,5191886672,266,1,132,113,245
1597,5191886672,266,2,137,123,260
1598,5191886672,266,3,116,142,258
1599,5191886672,266,4,115,123,238
1600,5191886672,266,5,134,126,260
1601,5191886672,266,6,124,115,239
1602,5191886800,267,1,131,125,256
1603,5191886800,267,2,141,103,244
1604,5191886800,267,3,132,130,262
1605,5191886800,267,4,108,135,243
1606,5191886800,267,5,117,121,238
1607,5191886800,267,6,129,128,257
1608,5191886928,268,1,123,118,241
1609,5191886928,268,2,141,103,244
1610,5191886928,268,3,132,130,262
1611,5191886928,268,4,116,142,258
1612,5191886928,268,5,117,121,238
1613,5191886928,268,6,129,128,257
1614,5191887056,269,1,130,126,256
1615,5191887056,269,2,141,103,244
1616,5191887056,269,3,132,130,262
1617,5191887056,269,4,109,134,243
1618,5191887056,269,5,117,121,238
1619,5191887056,269,6,129,128,257
1620,5191887184,270,1,130,126,256
1621,5191887184,270,2,141,103,244
1622,5191887184,270,3,129,121,250
1623,5191887184,270,4,112,143,255
1624,5191887184,270,5,117,121,238
1625,5191887184,270,6,129,128,257
1626,5191887312,271,1,114,134,248
1627,5191887312,271,2,147,108,255
1628,5191887312,271,3,138,121,259
1629,5191887312,271,4,110,137,247
1630,5191887312,271,5,127,116,243
1631,5191887312,271,6,122,126,248
1632,5191887440,272,1,110,133,243
1633,5191887440,272,2,142,116,258
1634,5191887440,272,3,127,121,248
1635,5191887440,272,4,122,132,254
1636,5191887440,272,5,135,114,249
1637,5191887440,272,6,122,126,248
1638,5191887568,273,1,121,124,245
1639,5191887568,273,2,144,119,263
1640,5191887568,273,3,112,131,243
1641,5191887568,273,4,130,121,251
1642,5191887568,273,5,122,128,250
1643,5191887568,273,6,129,119,248
1644,5191887696,274,1,123,121,244
1645,5191887696,274,2,141,110,251
1646,5191887696,274,3,110,128,238
1647,5191887696,274,4,129,131,260
1648,5191887696,274,5,127,124,251
1649,5191887696,274,6,128,128,256
1650,5191887824,275,1,121,135,256
1651,5191887824,275,2,138,112,250
1652,5191887824,275,3,114,131,245
1653,5191887824,275,4,133,121,254
1654,5191887824,275,5,133,117,250
1655,5191887824,275,6,119,126,245
1656,5191887952,276,1,127,121,248
1657,5191887952,276,2,132,128,260
1658,5191887952,276,3,112,133,245
1659,5191887952,276,4,124,122,246
1660,5191887952,276,5,133,120,253
1661,5191887952,276,6,130,118,248
1662,5191888208,277,1,114,123,237
1663,5191888208,277,2,132,128,260
1664,5191888208,277,3,120,131,251
1665,5191888208,277,4,123,118,241
1666,5191888208,277,5,139,124,263
1667,5191888208,277,6,130,118,248
1668,5191888464,278,1,123,126,249
1669,5191888464,278,2,124,115,239
1670,5191888464,278,3,117,141,258
1671,5191888464,278,4,134,114,248
1672,5191888464,278,5,126,120,246
1673,5191888464,278,6,134,126,260
1674,5191888592,279,1,131,127,258
1675,5191888592,279,2,121,123,244
1676,5191888592,279,3,113,137,250
1677,5191888592,279,4,130,117,247
1678,5191888592,279,5,128,110,238
1679,5191888592,279,6,135,128,263
1680,5191888720,280,1,124,118,242
1681,5191888720,280,2,121,123,244
1682,5191888720,280,3,113,137,250
1683,5191888720,280,4,137,126,263
1684,5191888720,280,5,128,110,238
1685,5191888720,280,6,135,128,263
1686,5191888848,281,1,113,136,249
1687,5191888848,281,2,141,115,256
1688,5191888848,281,3,131,130,261
1689,5191888848,281,4,126,115,241
1690,5191888848,281,5,134,113,247
1691,5191888848,281,6,113,133,246
1692,5194109200,282,1,108,143,251
1693,5194109200,282,2,124,115,239
1694,5194109200,282,3,148,110,258
1695,5194109200,282,4,123,121,244
1696,5194109200,282,5,132,121,253
1697,5194109200,282,6,123,132,255
1698,5194109328,283,1,119,127,246
1699,5194109328,283,2,124,121,245
1700,5194109328,283,3,134,118,252
1701,5194109328,283,4,127,119,246
1702,5194109328,283,5,126,129,255
1703,5194109328,283,6,128,128,256
1704,5194109456,284,1,134,104,238
1705,5194109456,284,2,126,116,242
1706,5194109456,284,3,143,117,260
1707,5194109456,284,4,118,142,260
1708,5194109456,284,5,124,137,261
1709,5194109456,284,6,113,126,239
1710,5194109584,285,1,118,128,246
1711,5194109584,285,2,133,118,251
1712,5194109584,285,3,144,110,254
1713,5194109584,285,4,123,135,258
1714,5194109584,285,5,121,125,246
1715,5194109584,285,6,119,126,245
1716,5194109712,286,1,117,131,248
1717,5194109712,286,2,140,110,250
1718,5194109712,286,3,136,105,241
1719,5194109712,286,4,116,132,248
1720,5194109712,286,5,124,137,261
1721,5194109712,286,6,125,127,252
1722,5194109840,287,1,110,137,247
1723,5194109840,287,2,147,104,251
1724,5194109840,287,3,135,122,257
1725,5194109840,287,4,115,133,248
1726,5194109840,287,5,124,130,254
1727,5194109840,287,6,127,116,243
1728,5194109968,288,1,108,129,237
1729,5194109968,288,2,136,106,242
1730,5194109968,288,3,142,117,259
1731,5194109968,288,4,114,134,248
1732,5194109968,288,5,122,137,259
1733,5194109968,288,6,136,119,255
1734,5194110096,289,1,115,130,245
1735,5194110096,289,2,148,113,261
1736,5194110096,289,3,121,123,244
1737,5194110096,289,4,128,129,257
1738,5194110096,289,5,126,128,254
1739,5194110096,289,6,120,119,239
1740,5194110224,290,1,148,114,262
1741,5194110224,290,2,119,119,238
1742,5194110224,290,3,130,120,250
1743,5194110224,290,4,113,148,261
1744,5194110224,290,5,124,116,240
1745,5194110224,290,6,124,125,249
1746,5194110352,291,1,139,110,249
1747,5194110352,291,2,128,131,259
1748,5194110352,291,3,130,120,250
1749,5194110352,291,4,108,143,251
1750,5194110352,291,5,133,121,254
1751,5194110352,291,6,120,117,237
1752,5194110480,292,1,133,109,242
1753,5194110480,292,2,123,139,262
1754,5194110480,292,3,122,133,255
1755,5194110480,292,4,117,129,246
1756,5194110480,292,5,129,111,240
1757,5194110480,292,6,134,121,255
1758,5194110608,293,1,129,118,247
1759,5194110608,293,2,111,133,244
1760,5194110608,293,3,134,127,261
1761,5194110608,293,4,114,128,242
1762,5194110608,293,5,145,113,258
1763,5194110608,293,6,125,123,248
1764,5194110736,294,1,121,126,247
1765,5194110736,294,2,132,123,255
1766,5194110736,294,3,132,116,248
1767,5194110736,294,4,115,130,245
1768,5194110736,294,5,133,120,253
1769,5194110736,294,6,125,127,252
1770,5194110864,295,1,126,134,260
1771,5194110864,295,2,125,117,242
1772,5194110864,295,3,137,106,243
1773,5194110864,295,4,111,141,252
1774,5194110864,295,5,138,121,259
1775,5194110864,295,6,121,123,244
1776,5194110992,296,1,126,134,260
1777,5194110992,296,2,132,127,259
1778,5194110992,296,3,137,106,243
1779,5194110992,296,4,111,141,252
1780,5194110992,296,5,131,111,242
1781,5194110992,296,6,121,123,244
1782,5194111120,297,1,120,143,263
1783,5194111120,297,2,128,131,259
1784,5194111120,297,3,130,118,248
1785,5194111120,297,4,117,120,237
1786,5194111120,297,5,130,109,239
1787,5194111120,297,6,133,121,254
1788,5194111248,298,1,120,143,263
1789,5194111248,298,2,120,117,237
1790,5194111248,298,3,130,118,248
1791,5194111248,298,4,117,120,237
1792,5194111248,298,5,138,123,261
1793,5194111248,298,6,133,121,254
1794,5194111376,299,1,116,129,245
1795,5194111376,299,2,119,126,245
1796,5194111376,299,3,133,105,238
1797,5194111376,299,4,121,133,254
1798,5194111376,299,5,126,129,255
1799,5194111376,299,6,143,120,263
1800,5194111632,300,1,125,125,250
1801,5194111632,300,2,117,127,244
1802,5194111632,300,3,151,112,263
1803,5194111632,300,4,111,128,239
1804,5194111632,300,5,120,125,245
1805,5194111632,300,6,134,125,259
1806,5194111760,301,1,124,134,258
1807,5194111760,301,2,122,126,248
1808,5194111760,301,3,147,108,255
1809,5194111760,301,4,115,126,241
1810,5194111760,301,5,129,126,255
1811,5194111760,301,6,121,122,243
1812,5194111888,302,1,122,123,245
1813,5194111888,302,2,143,119,262
1814,5194111888,302,3,132,109,241
1815,5194111888,302,4,133,124,257
1816,5194111888,302,5,115,134,249
1817,5194111888,302,6,113,133,246
1818,5194112016,303,1,110,133,243
1819,5194112016,303,2,136,109,245
1820,5194112016,303,3,140,123,263
1821,5194112016,303,4,145,105,250
1822,5194112016,303,5,109,138,247
1823,5194112016,303,6,118,134,252
1824,5194112144,304,1,115,133,248
1825,5194112144,304,2,121,118,239
1826,5194112144,304,3,138,106,244
1827,5194112144,304,4,137,109,246
1828,5194112144,304,5,121,142,263
1829,5194112144,304,6,126,134,260
1830,5194112400,305,1,118,132,250
1831,5194112400,305,2,121,118,239
1832,5194112400,305,3,138,106,244
1833,5194112400,305,4,145,116,261
1834,5194112400,305,5,110,136,246
1835,5194112400,305,6,126,134,260
1836,5194112528,306,1,120,142,262
1837,5194112528,306,2,127,115,242
1838,5194112528,306,3,121,135,256
1839,5194112528,306,4,135,120,255
1840,5194112528,306,5,128,110,238
1841,5194112528,306,6,127,120,247
1842,5194112656,307,1,120,142,262
1843,5194112656,307,2,127,115,242
1844,5194112656,307,3,117,123,240
1845,5194112656,307,4,135,120,255
1846,5194112656,307,5,132,122,254
1847,5194112656,307,6,127,120,247
1848,5194112784,308,1,116,147,263
1849,5194112784,308,2,130,122,252
1850,5194112784,308,3,123,115,238
1851,5194112784,308,4,127,115,242
1852,5194112784,308,5,140,115,255
1853,5194112784,308,6,122,128,250
1854,5194112912,309,1,114,136,250
1855,5194112912,309,2,118,123,241
1856,5194112912,309,3,145,118,263
1857,5194112912,309,4,132,122,254
1858,5194112912,309,5,127,118,245
1859,5194112912,309,6,122,125,247
1860,5196337232,310,1,130,126,256
1861,5196337232,310,2,135,123,258
1862,5196337232,310,3,109,134,243
1863,5196337232,310,4,126,117,243
1864,5196337232,310,5,129,128,257
1865,5196337232,310,6,129,114,243
1866,5196337360,311,1,119,125,244
1867,5196337360,311,2,129,132,261
1868,5196337360,311,3,113,130,243
1869,5196337360,311,4,131,118,249
1870,5196337360,311,5,126,120,246
1871,5196337360,311,6,140,117,257
1872,5196337488,312,1,129,134,263
1873,5196337488,312,2,123,128,251
1874,5196337488,312,3,117,138,255
1875,5196337488,312,4,128,109,237
1876,5196337488,312,5,126,120,246
1877,5196337488,312,6,135,113,248
1878,5196337616,313,1,131,129,260
1879,5196337616,313,2,122,126,248
1880,5196337616,313,3,119,128,247
1881,5196337616,313,4,129,123,252
1882,5196337616,313,5,130,120,250
1883,5196337616,313,6,127,116,243
1884,5196337744,314,1,128,130,258
1885,5196337744,314,2,122,125,247
1886,5196337744,314,3,110,134,244
1887,5196337744,314,4,136,113,249
1888,5196337744,314,5,131,111,242
1889,5196337744,314,6,131,129,260
1890,5196337872,315,1,125,122,247
1891,5196337872,315,2,129,129,258
1892,5196337872,315,3,115,129,244
1893,5196337872,315,4,144,108,252
1894,5196337872,315,5,126,129,255
1895,5196337872,315,6,119,125,244
1896,5196338128,316,1,118,125,243
1897,5196338128,316,2,129,119,248
1898,5196338128,316,3,129,131,260
1899,5196338128,316,4,147,108,255
1900,5196338128,316,5,119,134,253
1901,5196338128,316,6,116,125,241
1902,5196338256,317,1,126,132,258
1903,5196338256,317,2,129,119,248
1904,5196338256,317,3,121,124,245
1905,5196338256,317,4,147,108,255
1906,5196338256,317,5,119,134,253
1907,5196338256,317,6,116,125,241
1908,5196338384,318,1,129,132,261
1909,5196338384,318,2,125,116,241
1910,5196338384,318,3,116,131,247
1911,5196338384,318,4,131,112,243
1912,5196338384,318,5,128,125,253
1913,5196338384,318,6,129,126,255
1914,5196338512,319,1,124,129,253
1915,5196338512,319,2,149,111,260
1916,5196338512,319,3,120,123,243
1917,5196338512,319,4,132,128,260
1918,5196338512,319,5,111,129,240
1919,5196338512,319,6,122,122,244
1920,5196338640,320,1,124,129,253
1921,5196338640,320,2,139,104,243
1922,5196338640,320,3,130,130,260
1923,5196338640,320,4,132,128,260
1924,5196338640,320,5,111,129,240
1925,5196338640,320,6,122,122,244
1926,5196338768,321,1,121,125,246
1927,5196338768,321,2,139,104,243
1928,5196338768,321,3,129,132,261
1929,5196338768,321,4,131,130,261
1930,5196338768,321,5,111,129,240
1931,5196338768,321,6,127,122,249
1932,5196338896,322,1,121,125,246
1933,5196338896,322,2,139,104,243
1934,5196338896,322,3,121,120,241
1935,5196338896,322,4,131,130,261
1936,5196338896,322,5,119,141,260
1937,5196338896,322,6,127,122,249
1938,5196339024,323,1,149,110,259
1939,5196339024,323,2,126,122,248
1940,5196339024,323,3,111,141,252
1941,5196339024,323,4,124,123,247
1942,5196339024,323,5,128,112,240
1943,5196339024,323,6,120,134,254
1944,5196339408,324,1,129,111,240
1945,5196339408,324,2,123,132,255
1946,5196339408,324,3,114,131,245
1947,5196339408,324,4,135,123,258
1948,5196339408,324,5,139,112,251
1949,5196339408,324,6,118,133,251
1950,5196339664,325,1,124,117,241
1951,5196339664,325,2,113,133,246
1952,5196339664,325,3,114,147,261
1953,5196339664,325,4,133,112,245
1954,5196339664,325,5,141,117,258
1955,5196339664,325,6,133,116,249
1956,5196339792,326,1,128,124,252
1957,5196339792,326,2,113,133,246
1958,5196339792,326,3,110,140,250
1959,5196339792,326,4,133,112,245
1960,5196339792,326,5,141,117,258
1961,5196339792,326,6,133,116,249
1962,5196339920,327,1,132,121,253
1963,5196339920,327,2,126,128,254
1964,5196339920,327,3,121,135,256
1965,5196339920,327,4,142,111,253
1966,5196339920,327,5,121,121,242
1967,5196339920,327,6,116,126,242
1968,5196340048,328,1,119,128,247
1969,5196340048,328,2,122,128,250
1970,5196340048,328,3,112,137,249
1971,5196340048,328,4,141,107,248
1972,5196340048,328,5,126,125,251
1973,5196340048,328,6,138,117,255
1974,5196340176,329,1,126,130,256
1975,5196340176,329,2,122,125,247
1976,5196340176,329,3,125,130,255
1977,5196340176,329,4,134,124,258
1978,5196340176,329,5,120,121,241
1979,5196340176,329,6,131,112,243
1980,5196340304,330,1,126,130,256
1981,5196340304,330,2,122,125,247
1982,5196340304,330,3,119,133,252
1983,5196340304,330,4,140,121,261
1984,5196340304,330,5,120,121,241
1985,5196340304,330,6,131,112,243
1986,5196340432,331,1,129,121,250
1987,5196340432,331,2,123,128,251
1988,5196340432,331,3,117,143,260
1989,5196340432,331,4,138,124,262
1990,5196340432,331,5,130,109,239
1991,5196340432,331,6,121,117,238
1992,5196340560,332,1,125,125,250
1993,5196340560,332,2,119,126,245
1994,5196340560,332,3,119,136,255
1995,5196340560,332,4,134,112,246
1996,5196340560,332,5,138,123,261
1997,5196340560,332,6,123,120,243
1998,5196340688,333,1,125,125,250
1999,5196340688,333,2,119,126,245
2000,5196340688,333,3,110,131,241
2001,5196340688,333,4,134,112,246
2002,5196340688,333,5,138,123,261
2003,5196340688,333,6,132,125,257
2004,5196340816,334,1,128,128,256
2005,5196340816,334,2,117,127,244
2006,5196340816,334,3,120,123,243
2007,5196340816,334,4,132,116,248
2008,5196340816,334,5,140,121,261
2009,5196340816,334,6,121,127,248
2010,5196340944,335,1,123,136,259
2011,5196340944,335,2,116,127,243
2012,5196340944,335,3,131,131,262
2013,5196340944,335,4,147,108,255
2014,5196340944,335,5,120,117,237
2015,5196340944,335,6,121,123,244
2016,5196341072,336,1,134,124,258
2017,5196341072,336,2,121,118,239
2018,5196341072,336,3,113,140,253
2019,5196341072,336,4,142,103,245
2020,5196341072,336,5,127,136,263
2021,5196341072,336,6,121,121,242
2022,5196341200,337,1,135,109,244
2023,5196341200,337,2,129,129,258
2024,5196341200,337,3,118,144,262
2025,5196341200,337,4,138,107,245
2026,5196341200,337,5,118,123,241
2027,5196341200,337,6,120,130,250
2028,5198549136,338,1,140,106,246
2029,5198549136,338,2,121,123,244
2030,5198549136,338,3,116,142,258
2031,5198549136,338,4,122,117,239
2032,5198549136,338,5,136,117,253
2033,5198549136,338,6,123,137,260
2034,5198549264,339,1,140,106,246
2035,5198549264,339,2,121,123,244
2036,5198549264,339,3,117,140,257
2037,5198549264,339,4,122,117,239
2038,5198549264,339,5,136,117,253
2039,5198549264,339,6,122,139,261
2040,5198549392,340,1,122,132,254
2041,5198549392,340,2,132,116,248
2042,5198549392,340,3,117,138,255
2043,5198549392,340,4,119,122,241
2044,5198549392,340,5,136,105,241
2045,5198549392,340,6,132,129,261
2046,5198549520,341,1,124,131,255
2047,5198549520,341,2,134,110,244
2048,5198549520,341,3,110,134,244
2049,5198549520,341,4,141,122,263
2050,5198549520,341,5,126,120,246
2051,5198549520,341,6,123,125,248
2052,5198549648,342,1,129,132,261
2053,5198549648,342,2,129,109,238
2054,5198549648,342,3,110,137,247
2055,5198549648,342,4,134,114,248
2056,5198549648,342,5,126,120,246
2057,5198549648,342,6,130,130,260
2058,5198549776,343,1,129,132,261
2059,5198549776,343,2,129,109,238
2060,5198549776,343,3,110,137,247
2061,5198549776,343,4,142,121,263
2062,5198549776,343,5,126,120,246
2063,5198549776,343,6,122,123,245
2064,5198549904,344,1,135,121,256
2065,5198549904,344,2,113,137,250
2066,5198549904,344,3,127,116,243
2067,5198549904,344,4,134,121,255
2068,5198549904,344,5,122,126,248
2069,5198549904,344,6,127,121,248
2070,5198550032,345,1,141,116,257
2071,5198550032,345,2,118,139,257
2072,5198550032,345,3,132,126,258
2073,5198550032,345,4,121,125,246
2074,5198550032,345,5,119,126,245
2075,5198550032,345,6,127,110,237
2076,5198550160,346,1,126,121,247
2077,5198550160,346,2,126,137,263
2078,5198550160,346,3,146,107,253
2079,5198550160,346,4,118,120,238
2080,5198550160,346,5,113,126,239
2081,5198550160,346,6,129,131,260
2082,5198550288,347,1,126,131,257
2083,5198550288,347,2,126,119,245
2084,5198550288,347,3,141,110,251
2085,5198550288,347,4,121,135,256
2086,5198550288,347,5,122,119,241
2087,5198550288,347,6,122,128,250
2088,5198550416,348,1,118,128,246
2089,5198550416,348,2,146,113,259
2090,5198550416,348,3,138,112,250
2091,5198550416,348,4,114,132,246
2092,5198550416,348,5,132,121,253
2093,5198550416,348,6,110,136,246
2094,5198550544,349,1,127,132,259
2095,5198550544,349,2,137,109,246
2096,5198550544,349,3,139,111,250
2097,5198550544,349,4,114,134,248
2098,5198550544,349,5,123,117,240
2099,5198550544,349,6,118,139,257
2100,5198550672,350,1,122,126,248
2101,5198550672,350,2,120,131,251
2102,5198550672,350,3,123,118,241
2103,5198550672,350,4,123,128,251
2104,5198550672,350,5,136,115,251
2105,5198550672,350,6,134,124,258
2106,5198550800,351,1,130,126,256
2107,5198550800,351,2,117,124,241
2108,5198550800,351,3,125,125,250
2109,5198550800,351,4,124,128,252
2110,5198550800,351,5,131,126,257
2111,5198550800,351,6,131,113,244
2112,5198550928,352,1,136,111,247
2113,5198550928,352,2,110,136,246
2114,5198550928,352,3,142,120,262
2115,5198550928,352,4,121,128,249
2116,5198550928,352,5,116,130,246
2117,5198550928,352,6,133,117,250
2118,5198551056,353,1,137,115,252
2119,5198551056,353,2,110,132,242
2120,5198551056,353,3,137,111,248
2121,5198551056,353,4,122,134,256
2122,5198551056,353,5,116,134,250
2123,5198551056,353,6,136,116,252
2124,5198551184,354,1,138,119,257
2125,5198551184,354,2,113,137,250
2126,5198551184,354,3,134,105,239
2127,5198551184,354,4,119,125,244
2128,5198551184,354,5,133,127,260
2129,5198551184,354,6,121,129,250
2130,5198551312,355,1,133,119,252
2131,5198551312,355,2,113,137,250
2132,5198551312,355,3,134,105,239
2133,5198551312,355,4,124,125,249
2134,5198551312,355,5,133,127,260
2135,5198551312,355,6,121,129,250
2136,5198551568,356,1,128,112,240
2137,5198551568,356,2,113,137,250
2138,5198551568,356,3,134,105,239
2139,5198551568,356,4,129,132,261
2140,5198551568,356,5,133,127,260
2141,5198551568,356,6,121,129,250
2142,5198551696,357,1,130,126,256
2143,5198551696,357,2,121,131,252
2144,5198551696,357,3,138,104,242
2145,5198551696,357,4,119,141,260
2146,5198551696,357,5,117,130,247
2147,5198551696,357,6,133,110,243
2148,5198551824,358,1,120,130,250
2149,5198551824,358,2,118,128,246
2150,5198551824,358,3,121,125,246
2151,5198551824,358,4,124,118,242
2152,5198551824,358,5,149,111,260
2153,5198551824,358,6,126,130,256
2154,5198551952,359,1,116,121,237
2155,5198551952,359,2,118,128,246
2156,5198551952,359,3,121,125,246
2157,5198551952,359,4,128,127,255
2158,5198551952,359,5,149,111,260
2159,5198551952,359,6,126,130,256
2160,5198552080,360,1,142,112,254
2161,5198552080,360,2,129,123,252
2162,5198552080,360,3,117,140,257
2163,5198552080,360,4,111,129,240
2164,5198552080,360,5,140,112,252
2165,5198552080,360,6,119,126,245
2166,5198552208,361,1,130,124,254
2167,5198552208,361,2,147,108,255
2168,5198552208,361,3,108,129,237
2169,5198552208,361,4,125,127,252
2170,5198552208,361,5,119,125,244
2171,5198552208,361,6,129,129,258
2172,5198552464,362,1,132,125,257
2173,5198552464,362,2,142,110,252
2174,5198552464,362,3,122,136,258
2175,5198552464,362,4,117,125,242
2176,5198552464,362,5,116,134,250
2177,5198552464,362,6,129,112,241
2178,5198552592,363,1,129,122,251
2179,5198552592,363,2,131,111,242
2180,5198552592,363,3,117,140,257
2181,5198552592,363,4,120,130,250
2182,5198552592,363,5,119,127,246
2183,5198552592,363,6,142,112,254
2184,5198552720,364,1,135,126,261
2185,5198552720,364,2,133,109,242
2186,5198552720,364,3,110,128,238
2187,5198552720,364,4,118,125,243
2188,5198552720,364,5,127,129,256
2189,5198552720,364,6,135,125,260
2190,5198552848,365,1,119,130,249
2191,5198552848,365,2,137,112,249
2192,5198552848,365,3,113,132,245
2193,5198552848,365,4,140,117,257
2194,5198552848,365,5,132,128,260
2195,5198552848,365,6,117,123,240
2196,5198552976,366,1,120,142,262
2197,5198552976,366,2,128,118,246
2198,5198552976,366,3,123,134,257
2199,5198552976,366,4,141,109,250
2200,5198552976,366,5,116,127,243
2201,5198552976,366,6,130,112,242
2202,5200781456,367,1,114,136,250
2203,5200781456,367,2,128,118,246
2204,5200781456,367,3,123,134,257
2205,5200781456,367,4,141,109,250
2206,5200781456,367,5,116,127,243
2207,5200781456,367,6,136,118,254
2208,5200781520,368,1,132,120,252
2209,5200781520,368,2,135,128,263
2210,5200781520,368,3,118,140,258
2211,5200781520,368,4,136,102,238
2212,5200781520,368,5,113,126,239
2213,5200781520,368,6,124,126,250
2214,5200781776,369,1,120,134,254
2215,5200781776,369,2,125,116,241
2216,5200781776,369,3,144,112,256
2217,5200781776,369,4,130,116,246
2218,5200781776,369,5,119,126,245
2219,5200781776,369,6,120,138,258
2220,5200781904,370,1,115,127,242
2221,5200781904,370,2,125,116,241
2222,5200781904,370,3,144,112,256
2223,5200781904,370,4,135,123,258
2224,5200781904,370,5,119,126,245
2225,5200781904,370,6,120,138,258
2226,5200782032,371,1,119,132,251
2227,5200782032,371,2,127,121,248
2228,5200782032,371,3,140,113,253
2229,5200782032,371,4,125,124,249
2230,5200782032,371,5,122,126,248
2231,5200782032,371,6,125,126,251
2232,5200782160,372,1,119,132,251
2233,5200782160,372,2,127,122,249
2234,5200782160,372,3,140,113,253
2235,5200782160,372,4,125,124,249
2236,5200782160,372,5,122,125,247
2237,5200782160,372,6,125,126,251
2238,5200782288,373,1,121,116,237
2239,5200782288,373,2,145,111,256
2240,5200782288,373,3,136,127,263
2241,5200782288,373,4,122,118,240
2242,5200782288,373,5,117,130,247
2243,5200782288,373,6,117,140,257
2244,5200782416,374,1,112,137,249
2245,5200782416,374,2,125,117,242
2246,5200782416,374,3,144,111,255
2247,5200782416,374,4,130,127,257
2248,5200782416,374,5,129,128,257
2249,5200782416,374,6,118,122,240
2250,5200782544,375,1,112,137,249
2251,5200782544,375,2,138,114,252
2252,5200782544,375,3,142,103,245
2253,5200782544,375,4,115,131,246
2254,5200782544,375,5,119,126,245
2255,5200782544,375,6,132,131,263
2256,5200782672,376,1,121,130,251
2257,5200782672,376,2,144,108,252
2258,5200782672,376,3,137,126,263
2259,5200782672,376,4,127,125,252
2260,5200782672,376,5,115,125,240
2261,5200782672,376,6,114,128,242
2262,5200782800,377,1,129,122,251
2263,5200782800,377,2,131,110,241
2264,5200782800,377,3,137,121,258
2265,5200782800,377,4,112,131,243
2266,5200782800,377,5,132,131,263
2267,5200782800,377,6,117,127,244
2268,5200782928,378,1,131,117,248
2269,5200782928,378,2,131,110,241
2270,5200782928,378,3,137,121,258
2271,5200782928,378,4,120,143,263
2272,5200782928,378,5,122,124,246
2273,5200782928,378,6,117,127,244
2274,5200783056,379,1,133,130,263
2275,5200783056,379,2,120,132,252
2276,5200783056,379,3,122,120,242
2277,5200783056,379,4,139,103,242
2278,5200783056,379,5,131,131,262
2279,5200783056,379,6,113,126,239
2280,5200783184,380,1,128,133,261
2281,5200783184,380,2,117,138,255
2282,5200783184,380,3,124,119,243
2283,5200783184,380,4,134,111,245
2284,5200783184,380,5,133,116,249
2285,5200783184,380,6,122,125,247
2286,5200783312,381,1,112,127,239
2287,5200783312,381,2,118,139,257
2288,5200783312,381,3,128,122,250
2289,5200783312,381,4,142,113,255
2290,5200783312,381,5,129,112,241
2291,5200783312,381,6,129,129,258
2292,5200783440,382,1,119,135,254
2293,5200783440,382,2,117,138,255
2294,5200783440,382,3,130,118,248
2295,5200783440,382,4,140,114,254
2296,5200783440,382,5,130,112,242
2297,5200783440,382,6,122,125,247
2298,5200783568,383,1,118,126,244
2299,5200783568,383,2,117,138,255
2300,5200783568,383,3,141,122,263
2301,5200783568,383,4,137,113,250
2302,5200783568,383,5,132,117,249
2303,5200783568,383,6,113,126,239
2304,5200783824,384,1,114,134,248
2305,5200783824,384,2,121,142,263
2306,5200783824,384,3,115,123,238
2307,5200783824,384,4,134,106,240
2308,5200783824,384,5,145,118,263
2309,5200783824,384,6,129,119,248
2310,5200783952,385,1,115,133,248
2311,5200783952,385,2,121,142,263
2312,5200783952,385,3,121,124,245
2313,5200783952,385,4,142,115,257
2314,5200783952,385,5,136,111,247
2315,5200783952,385,6,123,117,240
2316,5200784080,386,1,133,113,246
2317,5200784080,386,2,121,142,263
2318,5200784080,386,3,133,123,256
2319,5200784080,386,4,130,116,246
2320,5200784080,386,5,118,130,248
2321,5200784080,386,6,123,118,241
2322,5200784208,387,1,116,126,242
2323,5200784208,387,2,129,129,258
2324,5200784208,387,3,124,121,245
2325,5200784208,387,4,146,104,250
2326,5200784208,387,5,122,139,261
2327,5200784208,387,6,121,123,244
2328,5200784336,388,1,120,136,256
2329,5200784336,388,2,122,129,251
2330,5200784336,388,3,127,122,249
2331,5200784336,388,4,133,109,242
2332,5200784336,388,5,134,121,255
2333,5200784336,388,6,122,125,247
2334,5200784464,389,1,117,135,252
2335,5200784464,389,2,120,129,249
2336,5200784464,389,3,119,136,255
2337,5200784464,389,4,138,105,243
2338,5200784464,389,5,122,116,238
2339,5200784464,389,6,142,121,263
2340,5200784592,390,1,118,144,262
2341,5200784592,390,2,144,119,263
2342,5200784592,390,3,118,134,252
2343,5200784592,390,4,130,107,237
2344,5200784592,390,5,120,128,248
2345,5200784592,390,6,128,110,238
2346,5200784720,391,1,120,131,251
2347,5200784720,391,2,117,127,244
2348,5200784720,391,3,127,119,246
2349,5200784720,391,4,129,126,255
2350,5200784720,391,5,132,124,256
2351,5200784720,391,6,133,115,248
2352,5200784848,392,1,114,134,248
2353,5200784848,392,2,131,128,259
2354,5200784848,392,3,126,122,248
2355,5200784848,392,4,141,116,257
2356,5200784848,392,5,122,119,241
2357,5200784848,392,6,124,123,247
2358,5200785104,393,1,122,136,258
2359,5200785104,393,2,128,124,252
2360,5200785104,393,3,113,126,239
2361,5200785104,393,4,118,139,257
2362,5200785104,393,5,132,107,239
2363,5200785104,393,6,145,110,255
2364,5200785232,394,1,113,133,246
2365,5200785232,394,2,138,125,263
2366,5200785232,394,3,113,126,239
2367,5200785232,394,4,120,139,259
2368,5200785232,394,5,132,114,246
2369,5200785232,394,6,142,105,247
2370,5200785360,395,1,135,106,241
2371,5200785360,395,2,127,122,249
2372,5200785360,395,3,116,127,243
2373,5200785360,395,4,119,141,260
2374,5200785360,395,5,118,135,253
2375,5200785360,395,6,143,111,254
2376,5202997392,396,1,116,127,243
2377,5202997392,396,2,138,123,261
2378,5202997392,396,3,120,129,249
2379,5202997392,396,4,128,128,256
2380,5202997392,396,5,123,126,249
2381,5202997392,396,6,133,109,242
2382,5202997520,397,1,123,133,256
2383,5202997520,397,2,138,123,261
2384,5202997520,397,3,120,129,249
2385,5202997520,397,4,120,123,243
2386,5202997520,397,5,124,125,249
2387,5202997520,397,6,133,109,242
2388,5202997648,398,1,126,132,258
2389,5202997648,398,2,138,123,261
2390,5202997648,398,3,120,129,249
2391,5202997648,398,4,120,123,243
2392,5202997648,398,5,121,126,247
2393,5202997648,398,6,133,109,242
2394,5202997776,399,1,121,128,249
2395,5202997776,399,2,117,127,244
2396,5202997776,399,3,135,111,246
2397,5202997776,399,4,121,135,256
2398,5202997776,399,5,130,130,260
2399,5202997776,399,6,134,111,245
2400,5202997904,400,1,122,127,249
2401,5202997904,400,2,117,127,244
2402,5202997904,400,3,132,115,247
2403,5202997904,400,4,133,129,262
2404,5202997904,400,5,128,128,256
2405,5202997904,400,6,126,116,242
2406,5202998032,401,1,129,123,252
2407,5202998032,401,2,126,125,251
2408,5202998032,401,3,136,121,257
2409,5202998032,401,4,117,140,257
2410,5202998032,401,5,122,117,239
2411,5202998032,401,6,128,116,244
2412,5202998160,402,1,112,142,254
2413,5202998160,402,2,125,133,258
2414,5202998160,402,3,127,110,237
2415,5202998160,402,4,123,123,246
2416,5202998160,402,5,133,122,255
2417,5202998160,402,6,138,112,250
2418,5202998288,403,1,131,126,257
2419,5202998288,403,2,117,121,238
2420,5202998288,403,3,140,112,252
2421,5202998288,403,4,119,134,253
2422,5202998288,403,5,124,126,250
2423,5202998288,403,6,127,123,250
2424,5202998416,404,1,120,131,251
2425,5202998416,404,2,131,130,261
2426,5202998416,404,3,134,111,245
2427,5202998416,404,4,117,124,241
2428,5202998416,404,5,130,125,255
2429,5202998416,404,6,126,121,247
2430,5202998544,405,1,120,131,251
2431,5202998544,405,2,126,121,247
2432,5202998544,405,3,139,120,259
2433,5202998544,405,4,117,124,241
2434,5202998544,405,5,130,125,255
2435,5202998544,405,6,126,121,247
2436,5202998672,406,1,120,133,253
2437,5202998672,406,2,122,128,250
2438,5202998672,406,3,137,105,242
2439,5202998672,406,4,124,123,247
2440,5202998672,406,5,136,125,261
2441,5202998672,406,6,119,128,247
2442,5202998800,407,1,112,137,249
2443,5202998800,407,2,122,126,248
2444,5202998800,407,3,130,117,247
2445,5202998800,407,4,123,135,258
2446,5202998800,407,5,137,103,240
2447,5202998800,407,6,134,124,258
2448,5202998928,408,1,111,136,247
2449,5202998928,408,2,122,125,247
2450,5202998928,408,3,124,124,248
2451,5202998928,408,4,128,130,258
2452,5202998928,408,5,137,108,245
2453,5202998928,408,6,136,119,255
2454,5202999056,409,1,124,124,248
2455,5202999056,409,2,121,123,244
2456,5202999056,409,3,121,124,245
2457,5202999056,409,4,133,117,250
2458,5202999056,409,5,149,114,263
2459,5202999056,409,6,110,140,250
2460,5202999184,410,1,120,117,237
2461,5202999184,410,2,121,123,244
2462,5202999184,410,3,121,124,245
2463,5202999184,410,4,133,117,250
2464,5202999184,410,5,149,114,263
2465,5202999184,410,6,114,147,261
2466,5202999312,411,1,142,118,260
2467,5202999312,411,2,122,125,247
2468,5202999312,411,3,121,124,245
2469,5202999312,411,4,116,132,248
2470,5202999312,411,5,139,99,238
2471,5202999312,411,6,118,144,262
2472,5202999440,412,1,125,124,249
2473,5202999440,412,2,132,116,248
2474,5202999440,412,3,124,123,247
2475,5202999440,412,4,124,137,261
2476,5202999440,412,5,140,106,246
2477,5202999440,412,6,113,136,249
2478,5202999568,413,1,124,120,244
2479,5202999568,413,2,124,131,255
2480,5202999568,413,3,132,121,253
2481,5202999568,413,4,124,116,240
2482,5202999568,413,5,146,111,257
2483,5202999568,413,6,108,143,251
2484,5202999696,414,1,127,116,243
2485,5202999696,414,2,121,139,260
2486,5202999696,414,3,128,109,237
2487,5202999696,414,4,130,127,257
2488,5202999696,414,5,133,121,254
2489,5202999696,414,6,119,130,249
2490,5202999824,415,1,127,116,243
2491,5202999824,415,2,121,139,260
2492,5202999824,415,3,128,109,237
2493,5202999824,415,4,127,118,245
2494,5202999824,415,5,133,121,254
2495,5202999824,415,6,122,139,261
2496,5203000080,416,1,128,120,248
2497,5203000080,416,2,128,119,247
2498,5203000080,416,3,117,130,247
2499,5203000080,416,4,121,135,256
2500,5203000080,416,5,119,122,241
2501,5203000080,416,6,145,116,261
2502,5203000208,417,1,122,123,245
2503,5203000208,417,2,136,111,247
2504,5203000208,417,3,131,126,257
2505,5203000208,417,4,121,124,245
2506,5203000208,417,5,111,141,252
2507,5203000208,417,6,137,117,254
2508,5203000336,418,1,116,131,247
2509,5203000336,418,2,129,116,245
2510,5203000336,418,3,126,133,259
2511,5203000336,418,4,130,109,239
2512,5203000336,418,5,129,121,250
2513,5203000336,418,6,128,132,260
2514,5203000464,419,1,133,128,261
2515,5203000464,419,2,129,111,240
2516,5203000464,419,3,123,139,262
2517,5203000464,419,4,138,101,239
2518,5203000464,419,5,125,126,251
2519,5203000464,419,6,110,137,247
2520,5203000592,420,1,129,125,254
2521,5203000592,420,2,139,120,259
2522,5203000592,420,3,123,139,262
2523,5203000592,420,4,138,101,239
2524,5203000592,420,5,119,120,239
2525,5203000592,420,6,110,137,247
2526,5203000720,421,1,133,107,240
2527,5203000720,421,2,140,114,254
2528,5203000720,421,3,111,133,244
2529,5203000720,421,4,129,129,258
2530,5203000720,421,5,127,136,263
2531,5203000720,421,6,118,123,241
2532,5203000848,422,1,133,114,247
2533,5203000848,422,2,143,119,262
2534,5203000848,422,3,113,133,246
2535,5203000848,422,4,126,119,245
2536,5203000848,422,5,113,137,250
2537,5203000848,422,6,130,120,250
2538,5203000976,423,1,137,122,259
2539,5203000976,423,2,127,110,237
2540,5203000976,423,3,122,132,254
2541,5203000976,423,4,130,120,250
2542,5203000976,423,5,119,136,255
2543,5203000976,423,6,123,122,245
2544,5203001104,424,1,125,118,243
2545,5203001104,424,2,138,109,247
2546,5203001104,424,3,129,128,257
2547,5203001104,424,4,116,142,258
2548,5203001104,424,5,112,125,237
2549,5203001104,424,6,138,120,258
2550,5203001232,425,1,132,117,249
2551,5203001232,425,2,145,115,260
2552,5203001232,425,3,119,127,246
2553,5203001232,425,4,117,121,238
2554,5203001232,425,5,117,129,246
2555,5203001232,425,6,128,133,261
2556,5205233744,426,1,135,122,257
2557,5205233744,426,2,133,104,237
2558,5205233744,426,3,121,139,260
2559,5205233744,426,4,115,122,237
2560,5205233744,426,5,116,132,248
2561,5205233744,426,6,138,123,261
2562,5205233872,427,1,142,117,259
2563,5205233872,427,2,131,127,258
2564,5205233872,427,3,123,121,244
2565,5205233872,427,4,115,122,237
2566,5205233872,427,5,111,136,247
2567,5205233872,427,6,136,119,255
2568,5205234000,428,1,140,102,242
2569,5205234000,428,2,127,116,243
2570,5205234000,428,3,125,133,258
2571,5205234000,428,4,117,129,246
2572,5205234000,428,5,119,143,262
2573,5205234000,428,6,130,119,249
2574,5205234128,429,1,135,120,255
2575,5205234128,429,2,125,119,244
2576,5205234128,429,3,115,131,246
2577,5205234128,429,4,120,143,263
2578,5205234128,429,5,138,99,237
2579,5205234128,429,6,125,130,255
2580,5205234256,430,1,127,121,248
2581,5205234256,430,2,127,119,246
2582,5205234256,430,3,123,130,253
2583,5205234256,430,4,120,143,263
2584,5205234256,430,5,138,99,237
2585,5205234256,430,6,123,130,253
2586,5205234384,431,1,134,128,262
2587,5205234384,431,2,123,121,244
2588,5205234384,431,3,123,128,251
2589,5205234384,431,4,116,131,247
2590,5205234384,431,5,141,107,248
2591,5205234384,431,6,121,127,248
2592,5205234512,432,1,130,107,237
2593,5205234512,432,2,148,113,261
2594,5205234512,432,3,115,131,246
2595,5205234512,432,4,115,133,248
2596,5205234512,432,5,139,117,256
2597,5205234512,432,6,111,141,252
2598,5205234640,433,1,144,112,256
2599,5205234640,433,2,112,132,244
2600,5205234640,433,3,117,127,244
2601,5205234640,433,4,141,115,256
2602,5205234640,433,5,130,122,252
2603,5205234640,433,6,114,134,248
2604,5205234768,434,1,144,112,256
2605,5205234768,434,2,112,132,244
2606,5205234768,434,3,117,127,244
2607,5205234768,434,4,135,111,246
2608,5205234768,434,5,130,122,252
2609,5205234768,434,6,120,138,258
2610,5205234896,435,1,133,123,256
2611,5205234896,435,2,130,108,238
2612,5205234896,435,3,113,126,239
2613,5205234896,435,4,137,120,257
2614,5205234896,435,5,124,137,261
2615,5205234896,435,6,121,128,249
2616,5205235024,436,1,127,122,249
2617,5205235024,436,2,128,119,247
2618,5205235024,436,3,122,125,247
2619,5205235024,436,4,146,116,262
2620,5205235024,436,5,118,140,258
2621,5205235024,436,6,117,120,237
2622,5205235152,437,1,125,125,250
2623,5205235152,437,2,134,125,259
2624,5205235152,437,3,119,126,245
2625,5205235152,437,4,138,103,241
2626,5205235152,437,5,120,134,254
2627,5205235152,437,6,122,129,251
2628,5205235280,438,1,113,126,239
2629,5205235280,438,2,135,118,253
2630,5205235280,438,3,128,132,260
2631,5205235280,438,4,133,114,247
2632,5205235280,438,5,126,125,251
2633,5205235280,438,6,123,127,250
2634,5205235408,439,1,113,126,239
2635,5205235408,439,2,115,129,244
2636,5205235408,439,3,132,128,260
2637,5205235408,439,4,135,112,247
2638,5205235408,439,5,124,137,261
2639,5205235408,439,6,139,110,249
2640,5205235536,440,1,117,130,247
2641,5205235536,440,2,119,129,248
2642,5205235536,440,3,139,120,259
2643,5205235536,440,4,128,121,249
2644,5205235536,440,5,116,132,248
2645,5205235536,440,6,139,110,249
2646,5205235664,441,1,123,130,253
2647,5205235664,441,2,119,129,248
2648,5205235664,441,3,133,120,253
2649,5205235664,441,4,128,121,249
2650,5205235664,441,5,116,132,248
2651,5205235664,441,6,139,110,249
2652,5205235792,442,1,136,121,257
2653,5205235792,442,2,127,134,261
2654,5205235792,442,3,137,115,252
2655,5205235792,442,4,113,126,239
2656,5205235792,442,5,122,129,251
2657,5205235792,442,6,123,117,240
2658,5205235920,443,1,134,126,260
2659,5205235920,443,2,120,128,248
2660,5205235920,443,3,129,118,247
2661,5205235920,443,4,127,132,259
2662,5205235920,443,5,111,129,240
2663,5205235920,443,6,137,109,246
2664,5205236048,444,1,134,126,260
2665,5205236048,444,2,126,123,249
2666,5205236048,444,3,129,118,247
2667,5205236048,444,4,127,132,259
2668,5205236048,444,5,111,129,240
2669,5205236048,444,6,131,114,245
2670,5205236176,445,1,132,112,244
2671,5205236176,445,2,115,142,257
2672,5205236176,445,3,122,117,239
2673,5205236176,445,4,122,136,258
2674,5205236176,445,5,131,128,259
2675,5205236176,445,6,136,107,243
2676,5205236304,446,1,133,109,242
2677,5205236304,446,2,128,118,246
2678,5205236304,446,3,123,132,255
2679,5205236304,446,4,123,132,255
2680,5205236304,446,5,126,136,262
2681,5205236304,446,6,125,115,240
2682,5205236432,447,1,134,108,242
2683,5205236432,447,2,118,125,243
2684,5205236432,447,3,121,134,255
2685,5205236432,447,4,132,130,262
2686,5205236432,447,5,118,120,238
2687,5205236432,447,6,135,125,260
2688,5205236560,448,1,138,104,242
2689,5205236560,448,2,122,123,245
2690,5205236560,448,3,116,139,255
2691,5205236560,448,4,122,131,253
2692,5205236560,448,5,134,122,256
2693,5205236560,448,6,126,123,249
2694,5205236688,449,1,142,115,257
2695,5205236688,449,2,122,140,262
2696,5205236688,449,3,117,141,258
2697,5205236688,449,4,133,106,239
2698,5205236688,449,5,128,113,241
2699,5205236688,449,6,116,127,243
2700,5205236816,450,1,146,111,257
2701,5205236816,450,2,112,142,254
2702,5205236816,450,3,121,122,243
2703,5205236816,450,4,127,121,248
2704,5205236816,450,5,130,120,250
2705,5205236816,450,6,122,126,248
2706,5205236944,451,1,146,107,253
2707,5205236944,451,2,109,139,248
2708,5205236944,451,3,127,134,261
2709,5205236944,451,4,132,115,247
2710,5205236944,451,5,130,118,248
2711,5205236944,451,6,114,129,243
2712,5205237072,452,1,146,107,253
2713,5205237072,452,2,113,148,261
2714,5205237072,452,3,123,125,248
2715,5205237072,452,4,132,115,247
2716,5205237072,452,5,130,118,248
2717,5205237072,452,6,114,129,243
2718,5205237200,453,1,140,117,257
2719,5205237200,453,2,109,129,238
2720,5205237200,453,3,126,119,245
2721,5205237200,453,4,125,119,244
2722,5205237200,453,5,135,128,263
2723,5205237200,453,6,123,130,253
2724,5205237328,454,1,133,129,262
2725,5205237328,454,2,105,134,239
2726,5205237328,454,3,128,121,249
2727,5205237328,454,4,121,117,238
2728,5205237328,454,5,130,121,251
2729,5205237328,454,6,141,120,261
2730,5205237456,455,1,123,118,241
2731,5205237456,455,2,119,124,243
2732,5205237456,455,3,118,130,248
2733,5205237456,455,4,141,114,255
2734,5205237456,455,5,121,133,254
2735,5205237456,455,6,136,123,259
2736,5205237584,456,1,123,118,241
2737,5205237584,456,2,118,136,254
2738,5205237584,456,3,121,129,250
2739,5205237584,456,4,141,114,255
2740,5205237584,456,5,126,132,258
2741,5205237584,456,6,129,113,242
2742,5205237712,457,1,133,129,262
2743,5205237712,457,2,114,132,246
2744,5205237712,457,3,132,126,258
2745,5205237712,457,4,140,102,242
2746,5205237712,457,5,117,131,248
2747,5205237712,457,6,122,122,244
2748,5207449744,458,1,128,121,249
2749,5207449744,458,2,117,130,247
2750,5207449744,458,3,138,123,261
2751,5207449744,458,4,140,110,250
2752,5207449744,458,5,116,132,248
2753,5207449744,458,6,119,126,245
2754,5207449872,459,1,113,126,239
2755,5207449872,459,2,122,128,250
2756,5207449872,459,3,127,122,249
2757,5207449872,459,4,142,118,260
2758,5207449872,459,5,116,142,258
2759,5207449872,459,6,138,106,244
2760,5207450000,460,1,113,126,239
2761,5207450000,460,2,126,135,261
2762,5207450000,460,3,123,115,238
2763,5207450000,460,4,142,118,260
2764,5207450000,460,5,116,142,258
2765,5207450000,460,6,138,106,244
2766,5207450128,461,1,113,126,239
2767,5207450128,461,2,118,128,246
2768,5207450128,461,3,131,122,253
2769,5207450128,461,4,142,118,260
2770,5207450128,461,5,116,142,258
2771,5207450128,461,6,138,106,244
2772,5207450256,462,1,122,125,247
2773,5207450256,462,2,128,115,243
2774,5207450256,462,3,117,126,243
2775,5207450256,462,4,134,115,249
2776,5207450256,462,5,117,140,257
2777,5207450256,462,6,140,121,261
2778,5207450384,463,1,121,120,241
2779,5207450384,463,2,120,143,263
2780,5207450384,463,3,125,120,245
2781,5207450384,463,4,128,121,249
2782,5207450384,463,5,139,124,263
2783,5207450384,463,6,125,114,239
2784,5207450512,464,1,131,124,255
2785,5207450512,464,2,128,129,257
2786,5207450512,464,3,126,124,250
2787,5207450512,464,4,129,117,246
2788,5207450512,464,5,125,122,247
2789,5207450512,464,6,119,126,245
2790,5207450640,465,1,135,124,259
2791,5207450640,465,2,138,121,259
2792,5207450640,465,3,118,132,250
2793,5207450640,465,4,144,111,255
2794,5207450640,465,5,110,128,238
2795,5207450640,465,6,113,126,239
2796,5207450768,466,1,133,129,262
2797,5207450768,466,2,134,119,253
2798,5207450768,466,3,121,137,258
2799,5207450768,466,4,134,103,237
2800,5207450768,466,5,114,126,240
2801,5207450768,466,6,122,128,250
2802,5207450896,467,1,120,121,241
2803,5207450896,467,2,120,136,256
2804,5207450896,467,3,121,132,253
2805,5207450896,467,4,135,123,258
2806,5207450896,467,5,140,105,245
2807,5207450896,467,6,122,125,247
2808,5207451024,468,1,120,121,241
2809,5207451024,468,2,119,135,254
2810,5207451024,468,3,122,133,255
2811,5207451024,468,4,135,123,258
2812,5207451024,468,5,140,105,245
2813,5207451024,468,6,122,125,247
2814,5207451152,469,1,121,121,242
2815,5207451152,469,2,119,134,253
2816,5207451152,469,3,122,133,255
2817,5207451152,469,4,134,123,257
2818,5207451152,469,5,140,106,246
2819,5207451152,469,6,122,125,247
2820,5207451280,470,1,128,123,251
2821,5207451280,470,2,119,135,254
2822,5207451280,470,3,114,127,241
2823,5207451280,470,4,134,119,253
2824,5207451280,470,5,144,112,256
2825,5207451280,470,6,119,126,245
2826,5207451408,471,1,137,124,261
2827,5207451408,471,2,119,125,244
2828,5207451408,471,3,112,135,247
2829,5207451408,471,4,137,126,263
2830,5207451408,471,5,140,106,246
2831,5207451408,471,6,113,126,239
2832,5207451536,472,1,137,124,261
2833,5207451536,472,2,119,125,244
2834,5207451536,472,3,113,137,250
2835,5207451536,472,4,136,124,260
2836,5207451536,472,5,140,106,246
2837,5207451536,472,6,113,126,239
2838,5207451664,473,1,128,121,249
2839,5207451664,473,2,117,126,243
2840,5207451664,473,3,115,138,253
2841,5207451664,473,4,140,122,262
2842,5207451664,473,5,145,109,254
2843,5207451664,473,6,113,126,239
2844,5207451792,474,1,121,124,245
2845,5207451792,474,2,122,141,263
2846,5207451792,474,3,126,118,244
2847,5207451792,474,4,128,126,254
2848,5207451792,474,5,135,105,240
2849,5207451792,474,6,126,128,254
2850,5207451920,475,1,121,124,245
2851,5207451920,475,2,114,140,254
2852,5207451920,475,3,126,118,244
2853,5207451920,475,4,128,126,254
2854,5207451920,475,5,143,106,249
2855,5207451920,475,6,126,128,254
2856,5207452176,476,1,137,109,246
2857,5207452176,476,2,118,139,257
2858,5207452176,476,3,120,129,249
2859,5207452176,476,4,129,117,246
2860,5207452176,476,5,114,129,243
2861,5207452176,476,6,140,119,259
2862,5207452304,477,1,118,128,246
2863,5207452304,477,2,136,113,249
2864,5207452304,477,3,119,135,254
2865,5207452304,477,4,137,118,255
2866,5207452304,477,5,122,129,251
2867,5207452304,477,6,126,119,245
2868,5207452560,478,1,116,136,252
2869,5207452560,478,2,125,119,244
2870,5207452560,478,3,124,126,250
2871,5207452560,478,4,130,114,244
2872,5207452560,478,5,129,122,251
2873,5207452560,478,6,134,125,259
2874,5207452688,479,1,113,126,239
2875,5207452688,479,2,125,117,242
2876,5207452688,479,3,125,125,250
2877,5207452688,479,4,140,121,261
2878,5207452688,479,5,121,128,249
2879,5207452688,479,6,134,125,259
2880,5207452816,480,1,122,121,243
2881,5207452816,480,2,125,136,261
2882,5207452816,480,3,126,113,239
2883,5207452816,480,4,131,124,255
2884,5207452816,480,5,118,134,252
2885,5207452816,480,6,136,114,250
2886,5207452944,481,1,111,136,247
2887,5207452944,481,2,117,133,250
2888,5207452944,481,3,129,125,254
2889,5207452944,481,4,143,104,247
2890,5207452944,481,5,113,126,239
2891,5207452944,481,6,145,118,263
2892,5207453072,482,1,114,126,240
2893,5207453072,482,2,122,131,253
2894,5207453072,482,3,127,123,250
2895,5207453072,482,4,127,134,261
2896,5207453072,482,5,124,118,242
2897,5207453072,482,6,144,110,254
2898,5207453200,483,1,114,126,240
2899,5207453200,483,2,122,131,253
2900,5207453200,483,3,131,132,263
2901,5207453200,483,4,123,125,248
2902,5207453200,483,5,124,118,242
2903,5207453200,483,6,144,110,254
2904,5207453328,484,1,116,142,258
2905,5207453328,484,2,121,120,241
2906,5207453328,484,3,126,129,255
2907,5207453328,484,4,132,117,249
2908,5207453328,484,5,125,114,239
2909,5207453328,484,6,138,120,258
2910,5207453456,485,1,130,129,259
2911,5207453456,485,2,122,128,250
2912,5207453456,485,3,120,123,243
2913,5207453456,485,4,133,121,254
2914,5207453456,485,5,127,120,247
2915,5207453456,485,6,126,121,247
2916,5207453584,486,1,141,122,263
2917,5207453584,486,2,113,126,239
2918,5207453584,486,3,119,127,246
2919,5207453584,486,4,130,125,255
2920,5207453584,486,5,130,107,237
2921,5207453584,486,6,125,135,260
2922,5209682000,487,1,130,125,255
2923,5209682000,487,2,117,127,244
2924,5209682000,487,3,107,134,241
2925,5209682000,487,4,112,131,243
2926,5209682000,487,5,142,114,256
2927,5209682000,487,6,150,111,261
2928,5209682128,488,1,124,123,247
2929,5209682128,488,2,122,126,248
2930,5209682128,488,3,113,140,253
2931,5209682128,488,4,124,126,250
2932,5209682128,488,5,127,114,241
2933,5209682128,488,6,148,113,261
2934,5209682256,489,1,124,123,247
2935,5209682256,489,2,122,126,248
2936,5209682256,489,3,110,131,241
2937,5209682256,489,4,124,126,250
2938,5209682256,489,5,130,123,253
2939,5209682256,489,6,148,113,261
2940,5209682384,490,1,124,123,247
2941,5209682384,490,2,122,126,248
2942,5209682384,490,3,106,140,246
2943,5209682384,490,4,124,126,250
2944,5209682384,490,5,134,114,248
2945,5209682384,490,6,148,113,261
2946,5209682512,491,1,118,123,241
2947,5209682512,491,2,126,128,254
2948,5209682512,491,3,128,109,237
2949,5209682512,491,4,119,137,256
2950,5209682512,491,5,126,137,263
2951,5209682512,491,6,141,108,249
2952,5209682640,492,1,121,126,247
2953,5209682640,492,2,123,119,242
2954,5209682640,492,3,113,137,250
2955,5209682640,492,4,132,122,254
2956,5209682640,492,5,130,126,256
2957,5209682640,492,6,139,112,251
2958,5209682768,493,1,121,126,247
2959,5209682768,493,2,125,116,241
2960,5209682768,493,3,115,125,240
2961,5209682768,493,4,121,125,246
2962,5209682768,493,5,126,137,263
2963,5209682768,493,6,150,113,263
2964,5209682896,494,1,123,139,262
2965,5209682896,494,2,137,124,261
2966,5209682896,494,3,104,135,239
2967,5209682896,494,4,127,125,252
2968,5209682896,494,5,129,116,245
2969,5209682896,494,6,138,103,241
2970,5209683024,495,1,126,124,250
2971,5209683024,495,2,121,123,244
2972,5209683024,495,3,125,136,261
2973,5209683024,495,4,130,112,242
2974,5209683024,495,5,111,129,240
2975,5209683024,495,6,145,118,263
2976,5209683152,496,1,129,126,255
2977,5209683152,496,2,130,123,253
2978,5209683152,496,3,117,137,254
2979,5209683152,496,4,136,106,242
2980,5209683152,496,5,115,135,250
2981,5209683152,496,6,131,115,246
2982,5209683280,497,1,140,120,260
2983,5209683280,497,2,121,125,246
2984,5209683280,497,3,127,121,248
2985,5209683280,497,4,147,106,253
2986,5209683280,497,5,110,137,247
2987,5209683280,497,6,113,133,246
2988,5209683408,498,1,135,102,237
2989,5209683408,498,2,134,120,254
2990,5209683408,498,3,121,131,252
2991,5209683408,498,4,119,126,245
2992,5209683408,498,5,113,136,249
2993,5209683408,498,6,136,127,263
2994,5209683536,499,1,129,114,243
2995,5209683536,499,2,124,120,244
2996,5209683536,499,3,116,142,258
2997,5209683536,499,4,134,123,257
2998,5209683536,499,5,127,120,247
2999,5209683536,499,6,128,123,251
3000,5209683664,500,1,120,121,241
3001,5209683664,500,2,131,127,258
3002,5209683664,500,3,123,119,242
3003,5209683664,500,4,113,126,239
3004,5209683664,500,5,137,126,263
3005,5209683664,500,6,134,123,257
3006,5209683792,501,1,119,137,256
3007,5209683792,501,2,140,113,253
3008,5209683792,501,3,125,115,240
3009,5209683792,501,4,132,120,252
3010,5209683792,501,5,125,130,255
3011,5209683792,501,6,117,127,244
3012,5209683920,502,1,109,130,239
3013,5209683920,502,2,117,130,247
3014,5209683920,502,3,128,123,251
3015,5209683920,502,4,141,114,255
3016,5209683920,502,5,123,137,260
3017,5209683920,502,6,140,108,248
3018,5209684304,503,1,116,142,258
3019,5209684304,503,2,117,130,247
3020,5209684304,503,3,124,119,243
3021,5209684304,503,4,141,114,255
3022,5209684304,503,5,123,137,260
3023,5209684304,503,6,137,100,237
3024,5209684432,504,1,111,129,240
3025,5209684432,504,2,119,126,245
3026,5209684432,504,3,135,126,261
3027,5209684432,504,4,138,123,261
3028,5209684432,504,5,128,116,244
3029,5209684432,504,6,127,122,249
3030,5209684560,505,1,118,139,257
3031,5209684560,505,2,119,126,245
3032,5209684560,505,3,135,126,261
3033,5209684560,505,4,131,113,244
3034,5209684560,505,5,128,116,244
3035,5209684560,505,6,127,122,249
3036,5209684688,506,1,121,133,254
3037,5209684688,506,2,128,128,256
3038,5209684688,506,3,134,118,252
3039,5209684688,506,4,124,121,245
3040,5209684688,506,5,129,119,248
3041,5209684688,506,6,122,123,245
3042,5209684816,507,1,121,133,254
3043,5209684816,507,2,128,128,256
3044,5209684816,507,3,134,118,252
3045,5209684816,507,4,124,121,245
3046,5209684816,507,5,131,120,251
3047,5209684816,507,6,120,122,242
3048,5209684944,508,1,136,115,251
3049,5209684944,508,2,122,126,248
3050,5209684944,508,3,134,126,260
3051,5209684944,508,4,117,138,255
3052,5209684944,508,5,124,121,245
3053,5209684944,508,6,125,116,241
3054,5209685072,509,1,133,111,244
3055,5209685072,509,2,121,123,244
3056,5209685072,509,3,141,122,263
3057,5209685072,509,4,129,122,251
3058,5209685072,509,5,117,128,245
3059,5209685072,509,6,117,136,253
3060,5209685200,510,1,138,112,250
3061,5209685200,510,2,124,116,240
3062,5209685200,510,3,141,122,263
3063,5209685200,510,4,121,128,249
3064,5209685200,510,5,123,126,249
3065,5209685200,510,6,111,138,249
3066,5209685328,511,1,114,133,247
3067,5209685328,511,2,136,121,257
3068,5209685328,511,3,146,107,253
3069,5209685328,511,4,120,131,251
3070,5209685328,511,5,122,128,250
3071,5209685328,511,6,120,122,242
3072,5209685456,512,1,138,104,242
3073,5209685456,512,2,128,128,256
3074,5209685456,512,3,131,130,261
3075,5209685456,512,4,113,137,250
3076,5209685456,512,5,131,122,253
3077,5209685456,512,6,117,121,238
3078,5209685584,513,1,121,117,238
3079,5209685584,513,2,121,129,250
3080,5209685584,513,3,125,122,247
3081,5209685584,513,4,119,128,247
3082,5209685584,513,5,136,119,255
3083,5209685584,513,6,136,127,263
3084,5209685712,514,1,138,123,261
3085,5209685712,514,2,131,113,244
3086,5209685712,514,3,118,139,257
3087,5209685712,514,4,131,108,239
3088,5209685712,514,5,130,132,262
3089,5209685712,514,6,110,127,237
3090,5209685840,515,1,131,121,252
3091,5209685840,515,2,133,118,251
3092,5209685840,515,3,122,136,258
3093,5209685840,515,4,131,108,239
3094,5209685840,515,5,129,128,257
3095,5209685840,515,6,112,131,243
3096,5209685968,516,1,140,121,261
3097,5209685968,516,2,118,140,258
3098,5209685968,516,3,113,126,239
3099,5209685968,516,4,122,120,242
3100,5209685968,516,5,145,112,257
3101,5209685968,516,6,120,123,243
3102,5211898000,517,1,127,124,251
3103,5211898000,517,2,118,130,248
3104,5211898000,517,3,113,126,239
3105,5211898000,517,4,134,123,257
3106,5211898000,517,5,143,101,244
3107,5211898000,517,6,123,138,261
3108,5211898256,518,1,135,115,250
3109,5211898256,518,2,128,113,241
3110,5211898256,518,3,133,127,260
3111,5211898256,518,4,128,125,253
3112,5211898256,518,5,117,138,255
3113,5211898256,518,6,117,124,241
3114,5211898384,519,1,135,120,255
3115,5211898384,519,2,137,100,237
3116,5211898384,519,3,130,125,255
3117,5211898384,519,4,125,132,257
3118,5211898384,519,5,112,131,243
3119,5211898384,519,6,119,134,253
3120,5211898512,520,1,129,118,247
3121,5211898512,520,2,134,112,246
3122,5211898512,520,3,143,119,262
3123,5211898512,520,4,113,133,246
3124,5211898512,520,5,117,138,255
3125,5211898512,520,6,122,122,244
3126,5211898640,521,1,129,131,260
3127,5211898640,521,2,145,116,261
3128,5211898640,521,3,124,123,247
3129,5211898640,521,4,126,122,248
3130,5211898640,521,5,118,127,245
3131,5211898640,521,6,116,123,239
3132,5211898896,522,1,121,124,245
3133,5211898896,522,2,145,116,261
3134,5211898896,522,3,124,123,247
3135,5211898896,522,4,126,122,248
3136,5211898896,522,5,118,127,245
3137,5211898896,522,6,124,130,254
3138,5211899024,523,1,120,119,239
3139,5211899024,523,2,138,105,243
3140,5211899024,523,3,132,121,253
3141,5211899024,523,4,117,126,243
3142,5211899024,523,5,124,137,261
3143,5211899024,523,6,127,134,261
3144,5211899152,524,1,125,125,250
3145,5211899152,524,2,146,114,260
3146,5211899152,524,3,132,121,253
3147,5211899152,524,4,117,126,243
3148,5211899152,524,5,118,127,245
3149,5211899152,524,6,120,129,249
3150,5211899280,525,1,112,131,243
3151,5211899280,525,2,145,112,257
3152,5211899280,525,3,122,126,248
3153,5211899280,525,4,127,121,248
3154,5211899280,525,5,125,131,256
3155,5211899280,525,6,127,121,248
3156,5211899408,526,1,108,130,238
3157,5211899408,526,2,141,109,250
3158,5211899408,526,3,122,125,247
3159,5211899408,526,4,127,122,249
3160,5211899408,526,5,125,135,260
3161,5211899408,526,6,135,121,256
3162,5211899536,527,1,108,130,238
3163,5211899536,527,2,141,109,250
3164,5211899536,527,3,119,126,245
3165,5211899536,527,4,130,121,251
3166,5211899536,527,5,125,135,260
3167,5211899536,527,6,135,121,256
3168,5211899664,528,1,126,137,263
3169,5211899664,528,2,136,104,240
3170,5211899664,528,3,130,123,253
3171,5211899664,528,4,114,128,242
3172,5211899664,528,5,130,112,242
3173,5211899664,528,6,122,138,260
3174,5211899920,529,1,115,133,248
3175,5211899920,529,2,141,107,248
3176,5211899920,529,3,130,123,253
3177,5211899920,529,4,114,128,242
3178,5211899920,529,5,144,114,258
3179,5211899920,529,6,114,137,251
3180,5211900048,530,1,117,143,260
3181,5211900048,530,2,135,108,243
3182,5211900048,530,3,127,111,238
3183,5211900048,530,4,123,139,262
3184,5211900048,530,5,144,114,258
3185,5211900048,530,6,112,127,239
3186,5211900176,531,1,117,143,260
3187,5211900176,531,2,135,108,243
3188,5211900176,531,3,136,122,258
3189,5211900176,531,4,114,128,242
3190,5211900176,531,5,144,114,258
3191,5211900176,531,6,112,127,239
3192,5211900304,532,1,107,132,239
3193,5211900304,532,2,135,108,243
3194,5211900304,532,3,136,122,258
3195,5211900304,532,4,114,128,242
3196,5211900304,532,5,144,114,258
3197,5211900304,532,6,122,138,260
3198,5211900432,533,1,114,139,253
3199,5211900432,533,2,132,106,238
3200,5211900432,533,3,122,128,250
3201,5211900432,533,4,124,123,247
3202,5211900432,533,5,134,121,255
3203,5211900432,533,6,132,125,257
3204,5211900560,534,1,125,136,261
3205,5211900560,534,2,129,119,248
3206,5211900560,534,3,127,122,249
3207,5211900560,534,4,136,125,261
3208,5211900560,534,5,123,114,237
3209,5211900560,534,6,118,126,244
3210,5211900688,535,1,132,124,256
3211,5211900688,535,2,126,116,242
3212,5211900688,535,3,126,134,260
3213,5211900688,535,4,126,123,249
3214,5211900688,535,5,136,108,244
3215,5211900688,535,6,112,137,249
3216,5211900944,536,1,109,130,239
3217,5211900944,536,2,143,118,261
3218,5211900944,536,3,126,128,254
3219,5211900944,536,4,120,117,237
3220,5211900944,536,5,133,129,262
3221,5211900944,536,6,127,120,247
3222,5211901072,537,1,119,134,253
3223,5211901072,537,2,122,137,259
3224,5211901072,537,3,139,120,259
3225,5211901072,537,4,135,105,240
3226,5211901072,537,5,127,114,241
3227,5211901072,537,6,116,132,248
3228,5211901200,538,1,114,133,247
3229,5211901200,538,2,116,134,250
3230,5211901200,538,3,134,111,245
3231,5211901200,538,4,135,105,240
3232,5211901200,538,5,137,121,258
3233,5211901200,538,6,122,138,260
3234,5211901328,539,1,115,133,248
3235,5211901328,539,2,122,141,263
3236,5211901328,539,3,132,107,239
3237,5211901328,539,4,133,120,253
3238,5211901328,539,5,114,132,246
3239,5211901328,539,6,142,109,251
3240,5211901456,540,1,118,122,240
3241,5211901456,540,2,113,126,239
3242,5211901456,540,3,129,128,257
3243,5211901456,540,4,143,119,262
3244,5211901456,540,5,127,134,261
3245,5211901456,540,6,128,113,241
3246,5211901584,541,1,119,120,239
3247,5211901584,541,2,113,126,239
3248,5211901584,541,3,129,128,257
3249,5211901584,541,4,143,119,262
3250,5211901584,541,5,117,123,240
3251,5211901584,541,6,137,126,263
3252,5211901840,542,1,126,120,246
3253,5211901840,542,2,127,134,261
3254,5211901840,542,3,133,117,250
3255,5211901840,542,4,128,117,245
3256,5211901840,542,5,110,139,249
3257,5211901840,542,6,134,115,249
3258,5214130256,543,1,122,131,253
3259,5214130256,543,2,144,108,252
3260,5214130256,543,3,127,127,254
3261,5214130256,543,4,116,131,247
3262,5214130256,543,5,120,124,244
3263,5214130256,543,6,129,121,250
3264,5214130384,544,1,140,106,246
3265,5214130384,544,2,133,129,262
3266,5214130384,544,3,120,117,237
3267,5214130384,544,4,126,123,249
3268,5214130384,544,5,122,140,262
3269,5214130384,544,6,117,127,244
3270,5214130512,545,1,146,111,257
3271,5214130512,545,2,128,122,250
3272,5214130512,545,3,131,130,261
3273,5214130512,545,4,117,123,240
3274,5214130512,545,5,114,129,243
3275,5214130512,545,6,122,127,249
3276,5214130640,546,1,122,131,253
3277,5214130640,546,2,116,137,253
3278,5214130640,546,3,139,104,243
3279,5214130640,546,4,135,125,260
3280,5214130640,546,5,117,124,241
3281,5214130640,546,6,129,121,250
3282,5214130768,547,1,113,126,239
3283,5214130768,547,2,106,140,246
3284,5214130768,547,3,125,119,244
3285,5214130768,547,4,128,133,261
3286,5214130768,547,5,145,115,260
3287,5214130768,547,6,141,109,250
3288,5214130896,548,1,113,126,239
3289,5214130896,548,2,113,148,261
3290,5214130896,548,3,125,119,244
3291,5214130896,548,4,121,125,246
3292,5214130896,548,5,145,115,260
3293,5214130896,548,6,141,109,250
3294,5214131024,549,1,117,127,244
3295,5214131024,549,2,110,132,242
3296,5214131024,549,3,139,104,243
3297,5214131024,549,4,129,124,253
3298,5214131024,549,5,133,130,263
3299,5214131024,549,6,130,125,255
3300,5214131152,550,1,117,127,244
3301,5214131152,550,2,120,134,254
3302,5214131152,550,3,136,105,241
3303,5214131152,550,4,124,130,254
3304,5214131152,550,5,127,121,248
3305,5214131152,550,6,134,125,259
3306,5214131408,551,1,122,128,250
3307,5214131408,551,2,119,141,260
3308,5214131408,551,3,147,108,255
3309,5214131408,551,4,115,125,240
3310,5214131408,551,5,133,123,256
3311,5214131408,551,6,122,117,239
3312,5214131536,552,1,118,128,246
3313,5214131536,552,2,127,131,258
3314,5214131536,552,3,124,118,242
3315,5214131536,552,4,138,124,262
3316,5214131536,552,5,114,136,250
3317,5214131536,552,6,137,105,242
3318,5214131664,553,1,147,106,253
3319,5214131664,553,2,118,140,258
3320,5214131664,553,3,129,128,257
3321,5214131664,553,4,116,121,237
3322,5214131664,553,5,129,121,250
3323,5214131664,553,6,119,126,245
3324,5214131792,554,1,108,129,237
3325,5214131792,554,2,142,110,252
3326,5214131792,554,3,124,129,253
3327,5214131792,554,4,135,128,263
3328,5214131792,554,5,127,120,247
3329,5214131792,554,6,122,126,248
3330,5214131920,555,1,108,129,237
3331,5214131920,555,2,142,110,252
3332,5214131920,555,3,116,122,238
3333,5214131920,555,4,135,128,263
3334,5214131920,555,5,135,127,262
3335,5214131920,555,6,122,126,248
3336,5214132048,556,1,124,139,263
3337,5214132048,556,2,138,113,251
3338,5214132048,556,3,140,123,263
3339,5214132048,556,4,112,132,244
3340,5214132048,556,5,116,123,239
3341,5214132048,556,6,128,112,240
3342,5214132176,557,1,127,119,246
3343,5214132176,557,2,134,118,252
3344,5214132176,557,3,119,129,248
3345,5214132176,557,4,117,121,238
3346,5214132176,557,5,133,125,258
3347,5214132176,557,6,128,130,258
3348,5214132304,558,1,136,125,261
3349,5214132304,558,2,126,122,248
3350,5214132304,558,3,125,120,245
3351,5214132304,558,4,118,126,244
3352,5214132304,558,5,144,119,263
3353,5214132304,558,6,109,130,239
3354,5214132432,559,1,136,125,261
3355,5214132432,559,2,127,121,248
3356,5214132432,559,3,124,121,245
3357,5214132432,559,4,118,126,244
3358,5214132432,559,5,144,119,263
3359,5214132432,559,6,109,130,239
3360,5214132560,560,1,128,129,257
3361,5214132560,560,2,127,127,254
3362,5214132560,560,3,124,117,241
3363,5214132560,560,4,119,126,245
3364,5214132560,560,5,139,119,258
3365,5214132560,560,6,121,124,245
3366,5214132688,561,1,120,118,238
3367,5214132688,561,2,136,110,246
3368,5214132688,561,3,114,132,246
3369,5214132688,561,4,117,130,247
3370,5214132688,561,5,145,116,261
3371,5214132688,561,6,126,136,262
3372,5214132816,562,1,119,136,255
3373,5214132816,562,2,132,126,258
3374,5214132816,562,3,123,120,243
3375,5214132816,562,4,119,126,245
3376,5214132816,562,5,142,107,249
3377,5214132816,562,6,123,127,250
3378,5214132944,563,1,115,129,244
3379,5214132944,563,2,132,126,258
3380,5214132944,563,3,127,127,254
3381,5214132944,563,4,119,126,245
3382,5214132944,563,5,142,107,249
3383,5214132944,563,6,123,127,250
3384,5214133072,564,1,119,144,263
3385,5214133072,564,2,118,126,244
3386,5214133072,564,3,132,131,263
3387,5214133072,564,4,133,111,244
3388,5214133072,564,5,120,125,245
3389,5214133072,564,6,136,105,241
3390,5214133200,565,1,110,140,250
3391,5214133200,565,2,119,136,255
3392,5214133200,565,3,131,120,251
3393,5214133200,565,4,137,113,250
3394,5214133200,565,5,133,117,250
3395,5214133200,565,6,128,116,244
3396,5214133328,566,1,113,149,262
3397,5214133328,566,2,119,136,255
3398,5214133328,566,3,131,120,251
3399,5214133328,566,4,137,113,250
3400,5214133328,566,5,130,108,238
3401,5214133328,566,6,128,116,244
3402,5214133584,567,1,126,136,262
3403,5214133584,567,2,121,124,245
3404,5214133584,567,3,126,128,254
3405,5214133584,567,4,143,104,247
3406,5214133584,567,5,119,125,244
3407,5214133584,567,6,123,125,248
3408,5214133712,568,1,118,140,258
3409,5214133712,568,2,123,131,254
3410,5214133712,568,3,152,110,262
3411,5214133712,568,4,133,115,248
3412,5214133712,568,5,120,119,239
3413,5214133712,568,6,112,127,239
3414,5214133840,569,1,112,130,242
3415,5214133840,569,2,115,123,238
3416,5214133840,569,3,143,119,262
3417,5214133840,569,4,132,108,240
3418,5214133840,569,5,134,124,258
3419,5214133840,569,6,122,138,260
3420,5214133968,570,1,133,108,241
3421,5214133968,570,2,127,110,237
3422,5214133968,570,3,123,127,250
3423,5214133968,570,4,142,119,261
3424,5214133968,570,5,122,137,259
3425,5214133968,570,6,111,141,252
3426,5214134096,571,1,131,106,237
3427,5214134096,571,2,139,122,261
3428,5214134096,571,3,116,125,241
3429,5214134096,571,4,138,125,263
3430,5214134096,571,5,120,131,251
3431,5214134096,571,6,114,133,247
3432,5214134224,572,1,131,106,237
3433,5214134224,572,2,139,122,261
3434,5214134224,572,3,126,136,262
3435,5214134224,572,4,128,114,242
3436,5214134224,572,5,120,131,251
3437,5214134224,572,6,114,133,247
3438,5216346256,573,1,140,120,260
3439,5216346256,573,2,133,117,250
3440,5216346256,573,3,117,133,250
3441,5216346256,573,4,138,117,255
3442,5216346256,573,5,118,120,238
3443,5216346256,573,6,112,135,247
3444,5216346384,574,1,132,113,245
3445,5216346384,574,2,126,128,254
3446,5216346384,574,3,118,139,257
3447,5216346384,574,4,130,115,245
3448,5216346384,574,5,129,121,250
3449,5216346384,574,6,123,126,249
3450,5216346640,575,1,131,117,248
3451,5216346640,575,2,113,126,239
3452,5216346640,575,3,116,142,258
3453,5216346640,575,4,126,119,245
3454,5216346640,575,5,137,114,251
3455,5216346640,575,6,135,124,259
3456,5216346768,576,1,128,124,252
3457,5216346768,576,2,116,127,243
3458,5216346768,576,3,118,139,257
3459,5216346768,576,4,124,130,254
3460,5216346768,576,5,143,111,254
3461,5216346768,576,6,129,111,240
3462,5216346896,577,1,127,124,251
3463,5216346896,577,2,118,126,244
3464,5216346896,577,3,119,141,260
3465,5216346896,577,4,134,129,263
3466,5216346896,577,5,138,99,237
3467,5216346896,577,6,122,123,245
3468,5216347024,578,1,121,128,249
3469,5216347024,578,2,134,125,259
3470,5216347024,578,3,125,130,255
3471,5216347024,578,4,119,118,237
3472,5216347024,578,5,138,112,250
3473,5216347024,578,6,121,129,250
3474,5216347152,579,1,141,110,251
3475,5216347152,579,2,113,126,239
3476,5216347152,579,3,117,133,250
3477,5216347152,579,4,126,115,241
3478,5216347152,579,5,146,116,262
3479,5216347152,579,6,115,142,257
3480,5216347280,580,1,141,110,251
3481,5216347280,580,2,113,126,239
3482,5216347280,580,3,117,133,250
3483,5216347280,580,4,131,122,253
3484,5216347280,580,5,146,116,262
3485,5216347280,580,6,110,135,245
3486,5216347408,581,1,141,110,251
3487,5216347408,581,2,113,126,239
3488,5216347408,581,3,117,133,250
3489,5216347408,581,4,124,114,238
3490,5216347408,581,5,146,116,262
3491,5216347408,581,6,117,143,260
3492,5216347536,582,1,138,99,237
3493,5216347536,582,2,122,128,250
3494,5216347536,582,3,129,128,257
3495,5216347536,582,4,130,131,261
3496,5216347536,582,5,112,135,247
3497,5216347536,582,6,127,121,248
3498,5216347664,583,1,119,126,245
3499,5216347664,583,2,128,123,251
3500,5216347664,583,3,133,127,260
3501,5216347664,583,4,138,109,247
3502,5216347664,583,5,119,130,249
3503,5216347664,583,6,121,127,248
3504,5216347792,584,1,113,126,239
3505,5216347792,584,2,133,125,258
3506,5216347792,584,3,141,122,263
3507,5216347792,584,4,137,106,243
3508,5216347792,584,5,117,138,255
3509,5216347792,584,6,117,125,242
3510,5216347920,585,1,113,126,239
3511,5216347920,585,2,133,125,258
3512,5216347920,585,3,141,122,263
3513,5216347920,585,4,137,106,243
3514,5216347920,585,5,109,131,240
3515,5216347920,585,6,125,132,257
3516,5216348048,586,1,119,126,245
3517,5216348048,586,2,138,114,252
3518,5216348048,586,3,131,107,238
3519,5216348048,586,4,127,121,248
3520,5216348048,586,5,127,136,263
3521,5216348048,586,6,116,138,254
3522,5216348176,587,1,119,126,245
3523,5216348176,587,2,138,114,252
3524,5216348176,587,3,143,118,261
3525,5216348176,587,4,127,121,248
3526,5216348176,587,5,117,129,246
3527,5216348176,587,6,114,134,248
3528,5216348304,588,1,113,126,239
3529,5216348304,588,2,141,109,250
3530,5216348304,588,3,131,128,259
3531,5216348304,588,4,117,123,240
3532,5216348304,588,5,145,115,260
3533,5216348304,588,6,111,141,252
3534,5216348432,589,1,113,126,239
3535,5216348432,589,2,141,109,250
3536,5216348432,589,3,131,128,259
3537,5216348432,589,4,117,123,240
3538,5216348432,589,5,142,119,261
3539,5216348432,589,6,114,137,251
3540,5216348560,590,1,113,126,239
3541,5216348560,590,2,141,109,250
3542,5216348560,590,3,127,116,243
3543,5216348560,590,4,121,135,256
3544,5216348560,590,5,142,119,261
3545,5216348560,590,6,114,137,251
3546,5216348816,591,1,121,117,238
3547,5216348816,591,2,121,129,250
3548,5216348816,591,3,136,110,246
3549,5216348816,591,4,145,117,262
3550,5216348816,591,5,118,123,241
3551,5216348816,591,6,117,146,263
3552,5216348944,592,1,138,114,252
3553,5216348944,592,2,111,133,244
3554,5216348944,592,3,121,116,237
3555,5216348944,592,4,141,112,253
3556,5216348944,592,5,131,125,256
3557,5216348944,592,6,116,142,258
3558,5216349072,593,1,123,118,241
3559,5216349072,593,2,120,119,239
3560,5216349072,593,3,129,119,248
3561,5216349072,593,4,146,111,257
3562,5216349072,593,5,128,133,261
3563,5216349072,593,6,112,142,254
3564,5216349200,594,1,136,122,258
3565,5216349200,594,2,114,128,242
3566,5216349200,594,3,120,120,240
3567,5216349200,594,4,150,108,258
3568,5216349200,594,5,121,125,246
3569,5216349200,594,6,117,139,256
3570,5216349328,595,1,136,118,254
3571,5216349328,595,2,119,136,255
3572,5216349328,595,3,129,119,248
3573,5216349328,595,4,140,106,246
3574,5216349328,595,5,126,130,256
3575,5216349328,595,6,108,133,241
3576,5216349456,596,1,127,120,247
3577,5216349456,596,2,124,128,252
3578,5216349456,596,3,114,133,247
3579,5216349456,596,4,147,110,257
3580,5216349456,596,5,119,120,239
3581,5216349456,596,6,127,131,258
3582,5216349584,597,1,137,122,259
3583,5216349584,597,2,124,130,254
3584,5216349584,597,3,120,131,251
3585,5216349584,597,4,138,106,244
3586,5216349584,597,5,118,127,245
3587,5216349584,597,6,121,126,247
3588,5216349712,598,1,141,114,255
3589,5216349712,598,2,112,132,244
3590,5216349712,598,3,120,139,259
3591,5216349712,598,4,143,111,254
3592,5216349712,598,5,123,121,244
3593,5216349712,598,6,119,125,244
3594,5216349968,599,1,141,117,258
3595,5216349968,599,2,111,133,244
3596,5216349968,599,3,116,132,248
3597,5216349968,599,4,145,111,256
3598,5216349968,599,5,123,121,244
3599,5216349968,599,6,122,128,250
3600,5216350096,600,1,136,116,252
3601,5216350096,600,2,116,134,250
3602,5216350096,600,3,116,132,248
3603,5216350096,600,4,145,111,256
3604,5216350096,600,5,119,121,240
3605,5216350096,600,6,126,128,254
3606,5218578512,601,1,134,126,260
3607,5218578512,601,2,113,126,239
3608,5218578512,601,3,120,143,263
3609,5218578512,601,4,144,103,247
3610,5218578512,601,5,129,118,247
3611,5218578512,601,6,118,126,244
3612,5218578640,602,1,134,123,257
3613,5218578640,602,2,113,126,239
3614,5218578640,602,3,109,138,247
3615,5218578640,602,4,152,111,263
3616,5218578640,602,5,138,119,257
3617,5218578640,602,6,112,125,237
3618,5218578768,603,1,120,131,251
3619,5218578768,603,2,133,123,256
3620,5218578768,603,3,116,123,239
3621,5218578768,603,4,139,112,251
3622,5218578768,603,5,125,121,246
3623,5218578768,603,6,125,132,257
3624,5218578896,604,1,122,131,253
3625,5218578896,604,2,124,118,242
3626,5218578896,604,3,118,133,251
3627,5218578896,604,4,146,117,263
3628,5218578896,604,5,127,124,251
3629,5218578896,604,6,121,119,240
3630,5218579024,605,1,127,118,245
3631,5218579024,605,2,139,121,260
3632,5218579024,605,3,144,111,255
3633,5218579024,605,4,116,130,246
3634,5218579024,605,5,121,118,239
3635,5218579024,605,6,111,144,255
3636,5218579152,606,1,127,128,255
3637,5218579152,606,2,122,128,250
3638,5218579152,606,3,139,103,242
3639,5218579152,606,4,126,128,254
3640,5218579152,606,5,122,116,238
3641,5218579152,606,6,122,139,261
3642,5218579280,607,1,123,134,257
3643,5218579280,607,2,119,126,245
3644,5218579280,607,3,138,106,244
3645,5218579280,607,4,128,126,254
3646,5218579280,607,5,129,123,252
3647,5218579280,607,6,121,127,248
3648,5218579408,608,1,131,126,257
3649,5218579408,608,2,117,130,247
3650,5218579408,608,3,133,126,259
3651,5218579408,608,4,128,112,240
3652,5218579408,608,5,127,125,252
3653,5218579408,608,6,122,123,245
3654,5218579536,609,1,126,120,246
3655,5218579536,609,2,117,127,244
3656,5218579536,609,3,125,125,250
3657,5218579536,609,4,148,114,262
3658,5218579536,609,5,134,126,260
3659,5218579536,609,6,108,130,238
3660,5218579664,610,1,126,120,246
3661,5218579664,610,2,117,127,244
3662,5218579664,610,3,125,125,250
3663,5218579664,610,4,148,114,262
3664,5218579664,610,5,127,118,245
3665,5218579664,610,6,115,138,253
3666,5218579792,611,1,140,114,254
3667,5218579792,611,2,119,136,255
3668,5218579792,611,3,150,110,260
3669,5218579792,611,4,122,127,249
3670,5218579792,611,5,112,130,242
3671,5218579792,611,6,115,125,240
3672,5218579920,612,1,113,126,239
3673,5218579920,612,2,124,118,242
3674,5218579920,612,3,149,110,259
3675,5218579920,612,4,131,120,251
3676,5218579920,612,5,124,137,261
3677,5218579920,612,6,117,131,248
3678,5218580048,613,1,127,119,246
3679,5218580048,613,2,140,118,258
3680,5218580048,613,3,134,104,238
3681,5218580048,613,4,125,118,243
3682,5218580048,613,5,116,142,258
3683,5218580048,613,6,116,141,257
3684,5218580176,614,1,126,134,260
3685,5218580176,614,2,134,108,242
3686,5218580176,614,3,126,112,238
3687,5218580176,614,4,130,129,259
3688,5218580176,614,5,134,124,258
3689,5218580176,614,6,108,135,243
3690,5218580304,615,1,124,130,254
3691,5218580304,615,2,142,103,245
3692,5218580304,615,3,118,126,244
3693,5218580304,615,4,131,126,257
3694,5218580304,615,5,128,129,257
3695,5218580304,615,6,115,128,243
3696,5218580432,616,1,124,130,254
3697,5218580432,616,2,142,103,245
3698,5218580432,616,3,120,127,247
3699,5218580432,616,4,131,126,257
3700,5218580432,616,5,128,129,257
3701,5218580432,616,6,113,127,240
3702,5218580560,617,1,120,117,237
3703,5218580560,617,2,145,113,258
3704,5218580560,617,3,117,140,257
3705,5218580560,617,4,135,103,238
3706,5218580560,617,5,117,130,247
3707,5218580560,617,6,124,139,263
3708,5218580688,618,1,120,117,237
3709,5218580688,618,2,142,114,256
3710,5218580688,618,3,117,140,257
3711,5218580688,618,4,135,103,238
3712,5218580688,618,5,120,129,249
3713,5218580688,618,6,124,139,263
3714,5218580944,619,1,124,118,242
3715,5218580944,619,2,143,104,247
3716,5218580944,619,3,116,142,258
3717,5218580944,619,4,141,116,257
3718,5218580944,619,5,113,126,239
3719,5218580944,619,6,121,136,257
3720,5218581072,620,1,129,128,257
3721,5218581072,620,2,143,105,248
3722,5218581072,620,3,130,129,259
3723,5218581072,620,4,131,119,250
3724,5218581072,620,5,113,126,239
3725,5218581072,620,6,112,135,247
3726,5218581200,621,1,129,123,252
3727,5218581200,621,2,146,108,254
3728,5218581200,621,3,118,122,240
3729,5218581200,621,4,126,114,240
3730,5218581200,621,5,123,128,251
3731,5218581200,621,6,116,147,263
3732,5218581328,622,1,130,130,260
3733,5218581328,622,2,147,112,259
3734,5218581328,622,3,117,123,240
3735,5218581328,622,4,124,115,239
3736,5218581328,622,5,128,120,248
3737,5218581328,622,6,112,142,254
3738,5218581456,623,1,134,104,238
3739,5218581456,623,2,136,125,261
3740,5218581456,623,3,124,137,261
3741,5218581456,623,4,113,126,239
3742,5218581456,623,5,133,108,241
3743,5218581456,623,6,118,142,260
3744,5218581584,624,1,144,111,255
3745,5218581584,624,2,130,125,255
3746,5218581584,624,3,124,137,261
3747,5218581584,624,4,113,126,239
3748,5218581584,624,5,133,108,241
3749,5218581584,624,6,114,135,249
3750,5218581712,625,1,143,114,257
3751,5218581712,625,2,125,128,253
3752,5218581712,625,3,119,125,244
3753,5218581712,625,4,116,127,243
3754,5218581712,625,5,141,114,255
3755,5218581712,625,6,114,134,248
3756,5218581840,626,1,146,112,258
3757,5218581840,626,2,118,122,240
3758,5218581840,626,3,117,140,257
3759,5218581840,626,4,122,126,248
3760,5218581840,626,5,141,119,260
3761,5218581840,626,6,114,123,237
3762,5218581968,627,1,150,108,258
3763,5218581968,627,2,126,123,249
3764,5218581968,627,3,115,134,249
3765,5218581968,627,4,119,126,245
3766,5218581968,627,5,126,128,254
3767,5218581968,627,6,122,123,245
3768,5218582096,628,1,144,110,254
3769,5218582096,628,2,130,126,256
3770,5218582096,628,3,119,134,253
3771,5218582096,628,4,129,129,258
3772,5218582096,628,5,118,123,241
3773,5218582096,628,6,118,120,238
3774,5218582224,629,1,144,109,253
3775,5218582224,629,2,120,119,239
3776,5218582224,629,3,119,135,254
3777,5218582224,629,4,119,126,245
3778,5218582224,629,5,128,126,254
3779,5218582224,629,6,128,127,255
3780,5218582352,630,1,136,122,258
3781,5218582352,630,2,136,117,253
3782,5218582352,630,3,112,131,243
3783,5218582352,630,4,133,127,260
3784,5218582352,630,5,126,120,246
3785,5218582352,630,6,115,125,240
3786,5218582480,631,1,127,117,244
3787,5218582480,631,2,140,116,256
3788,5218582480,631,3,117,139,256
3789,5218582480,631,4,133,123,256
3790,5218582480,631,5,120,117,237
3791,5218582480,631,6,121,130,251
3792,5220798608,632,1,117,127,244
3793,5220798608,632,2,142,105,247
3794,5220798608,632,3,119,141,260
3795,5220798608,632,4,142,111,253
3796,5220798608,632,5,127,122,249
3797,5220798608,632,6,111,136,247
3798,5220798736,633,1,114,128,242
3799,5220798736,633,2,121,116,237
3800,5220798736,633,3,126,137,263
3801,5220798736,633,4,137,123,260
3802,5220798736,633,5,141,114,255
3803,5220798736,633,6,119,124,243
3804,5220798864,634,1,123,139,262
3805,5220798864,634,2,121,116,237
3806,5220798864,634,3,126,137,263
3807,5220798864,634,4,128,112,240
3808,5220798864,634,5,141,114,255
3809,5220798864,634,6,119,124,243
3810,5220798992,635,1,126,120,246
3811,5220798992,635,2,131,113,244
3812,5220798992,635,3,113,137,250
3813,5220798992,635,4,132,114,246
3814,5220798992,635,5,126,127,253
3815,5220798992,635,6,130,131,261
3816,5220799120,636,1,121,135,256
3817,5220799120,636,2,135,118,253
3818,5220799120,636,3,131,106,237
3819,5220799120,636,4,138,115,253
3820,5220799120,636,5,113,126,239
3821,5220799120,636,6,120,142,262
3822,5220799248,637,1,130,127,257
3823,5220799248,637,2,113,132,245
3824,5220799248,637,3,132,130,262
3825,5220799248,637,4,128,128,256
3826,5220799248,637,5,135,108,243
3827,5220799248,637,6,120,117,237
3828,5220799504,638,1,130,127,257
3829,5220799504,638,2,113,132,245
3830,5220799504,638,3,132,130,262
3831,5220799504,638,4,118,119,237
3832,5220799504,638,5,145,117,262
3833,5220799504,638,6,120,117,237
3834,5220799760,639,1,134,120,254
3835,5220799760,639,2,127,117,244
3836,5220799760,639,3,136,121,257
3837,5220799760,639,4,123,132,255
3838,5220799760,639,5,110,128,238
3839,5220799760,639,6,128,124,252
3840,5220799888,640,1,138,121,259
3841,5220799888,640,2,138,103,241
3842,5220799888,640,3,116,127,243
3843,5220799888,640,4,130,118,248
3844,5220799888,640,5,125,129,254
3845,5220799888,640,6,111,144,255
3846,5220800016,641,1,138,121,259
3847,5220800016,641,2,138,103,241
3848,5220800016,641,3,116,127,243
3849,5220800016,641,4,133,127,260
3850,5220800016,641,5,125,129,254
3851,5220800016,641,6,108,135,243
3852,5220800528,642,1,140,114,254
3853,5220800528,642,2,136,110,246
3854,5220800528,642,3,117,127,244
3855,5220800528,642,4,134,126,260
3856,5220800528,642,5,116,130,246
3857,5220800528,642,6,115,135,250
3858,5220800656,643,1,110,128,238
3859,5220800656,643,2,137,117,254
3860,5220800656,643,3,122,141,263
3861,5220800656,643,4,145,103,248
3862,5220800656,643,5,130,126,256
3863,5220800656,643,6,114,127,241
3864,5220800784,644,1,110,128,238
3865,5220800784,644,2,137,117,254
3866,5220800784,644,3,122,141,263
3867,5220800784,644,4,145,103,248
3868,5220800784,644,5,123,118,241
3869,5220800784,644,6,121,135,256
3870,5220800912,645,1,110,128,238
3871,5220800912,645,2,137,117,254
3872,5220800912,645,3,122,141,263
3873,5220800912,645,4,145,103,248
3874,5220800912,645,5,128,125,253
3875,5220800912,645,6,116,128,244
3876,5220801040,646,1,130,127,257
3877,5220801040,646,2,127,110,237
3878,5220801040,646,3,119,126,245
3879,5220801040,646,4,133,109,242
3880,5220801040,646,5,133,123,256
3881,5220801040,646,6,116,147,263
3882,5220801168,647,1,117,129,246
3883,5220801168,647,2,138,114,252
3884,5220801168,647,3,124,131,255
3885,5220801168,647,4,145,118,263
3886,5220801168,647,5,122,115,237
3887,5220801168,647,6,112,135,247
3888,5220801296,648,1,117,140,257
3889,5220801296,648,2,143,120,263
3890,5220801296,648,3,117,121,238
3891,5220801296,648,4,130,121,251
3892,5220801296,648,5,141,113,254
3893,5220801296,648,6,110,127,237
3894,5220801424,649,1,117,140,257
3895,5220801424,649,2,143,120,263
3896,5220801424,649,3,129,132,261
3897,5220801424,649,4,125,118,243
3898,5220801424,649,5,131,106,237
3899,5220801424,649,6,113,126,239
3900,5220801552,650,1,125,138,263
3901,5220801552,650,2,134,124,258
3902,5220801552,650,3,117,127,244
3903,5220801552,650,4,136,121,257
3904,5220801552,650,5,129,112,241
3905,5220801552,650,6,117,120,237
3906,5220801680,651,1,145,112,257
3907,5220801680,651,2,137,115,252
3908,5220801680,651,3,121,126,247
3909,5220801680,651,4,121,121,242
3910,5220801680,651,5,109,138,247
3911,5220801680,651,6,125,130,255
3912,5220801808,652,1,117,138,255
3913,5220801808,652,2,112,132,244
3914,5220801808,652,3,131,114,245
3915,5220801808,652,4,130,129,259
3916,5220801808,652,5,142,111,253
3917,5220801808,652,6,126,118,244
3918,5220801936,653,1,117,138,255
3919,5220801936,653,2,112,132,244
3920,5220801936,653,3,131,114,245
3921,5220801936,653,4,125,122,247
3922,5220801936,653,5,142,111,253
3923,5220801936,653,6,131,125,256
3924,5220802064,654,1,110,137,247
3925,5220802064,654,2,128,135,263
3926,5220802064,654,3,125,117,242
3927,5220802064,654,4,129,121,250
3928,5220802064,654,5,145,111,256
3929,5220802064,654,6,121,121,242
3930,5220802192,655,1,115,133,248
3931,5220802192,655,2,121,125,246
3932,5220802192,655,3,138,121,259
3933,5220802192,655,4,116,122,238
3934,5220802192,655,5,141,121,262
3935,5220802192,655,6,127,120,247
3936,5220802320,656,1,117,133,250
3937,5220802320,656,2,122,136,258
3938,5220802320,656,3,127,111,238
3939,5220802320,656,4,124,130,254
3940,5220802320,656,5,143,118,261
3941,5220802320,656,6,125,114,239
3942,5220802448,657,1,117,133,250
3943,5220802448,657,2,122,136,258
3944,5220802448,657,3,127,111,238
3945,5220802448,657,4,120,123,243
3946,5220802448,657,5,143,118,261
3947,5220802448,657,6,129,121,250
3948,5223026768,658,1,122,121,243
3949,5223026768,658,2,122,136,258
3950,5223026768,658,3,127,111,238
3951,5223026768,658,4,122,140,262
3952,5223026768,658,5,131,108,239
3953,5223026768,658,6,134,126,260
3954,5223026896,659,1,131,128,259
3955,5223026896,659,2,121,129,250
3956,5223026896,659,3,130,109,239
3957,5223026896,659,4,118,142,260
3958,5223026896,659,5,128,113,241
3959,5223026896,659,6,130,121,251
3960,5223027024,660,1,137,111,248
3961,5223027024,660,2,122,126,248
3962,5223027024,660,3,124,134,258
3963,5223027024,660,4,116,142,258
3964,5223027024,660,5,136,111,247
3965,5223027024,660,6,123,118,241
3966,5223027152,661,1,130,113,243
3967,5223027152,661,2,113,126,239
3968,5223027152,661,3,117,138,255
3969,5223027152,661,4,126,133,259
3970,5223027152,661,5,139,117,256
3971,5223027152,661,6,133,115,248
3972,5223027280,662,1,133,114,247
3973,5223027280,662,2,122,126,248
3974,5223027280,662,3,120,139,259
3975,5223027280,662,4,121,116,237
3976,5223027280,662,5,134,126,260
3977,5223027280,662,6,128,121,249
3978,5223027408,663,1,122,123,245
3979,5223027408,663,2,136,122,258
3980,5223027408,663,3,123,135,258
3981,5223027408,663,4,131,121,252
3982,5223027408,663,5,118,126,244
3983,5223027408,663,6,128,115,243
3984,5223027536,664,1,123,127,250
3985,5223027536,664,2,145,112,257
3986,5223027536,664,3,126,131,257
3987,5223027536,664,4,128,123,251
3988,5223027536,664,5,111,133,244
3989,5223027536,664,6,125,116,241
3990,5223027792,665,1,133,130,263
3991,5223027792,665,2,135,103,238
3992,5223027792,665,3,120,134,254
3993,5223027792,665,4,134,120,254
3994,5223027792,665,5,111,133,244
3995,5223027792,665,6,125,122,247
3996,5223027920,666,1,128,119,247
3997,5223027920,666,2,141,110,251
3998,5223027920,666,3,126,117,243
3999,5223027920,666,4,128,133,261
4000,5223027920,666,5,112,132,244
4001,5223027920,666,6,123,131,254
4002,5223028048,667,1,128,119,247
4003,5223028048,667,2,141,110,251
4004,5223028048,667,3,130,129,259
4005,5223028048,667,4,124,121,245
4006,5223028048,667,5,112,132,244
4007,5223028048,667,6,123,131,254
4008,5223028304,668,1,127,110,237
4009,5223028304,668,2,122,125,247
4010,5223028304,668,3,126,130,256
4011,5223028304,668,4,116,141,257
4012,5223028304,668,5,121,124,245
4013,5223028304,668,6,146,112,258
4014,5223028432,669,1,138,118,256
4015,5223028432,669,2,122,125,247
4016,5223028432,669,3,126,130,256
4017,5223028432,669,4,116,141,257
4018,5223028432,669,5,121,124,245
4019,5223028432,669,6,135,104,239
4020,5223028560,670,1,126,122,248
4021,5223028560,670,2,138,113,251
4022,5223028560,670,3,115,124,239
4023,5223028560,670,4,115,133,248
4024,5223028560,670,5,122,141,263
4025,5223028560,670,6,142,109,251
4026,5223028816,671,1,126,116,242
4027,5223028816,671,2,139,116,255
4028,5223028816,671,3,133,129,262
4029,5223028816,671,4,121,117,238
4030,5223028816,671,5,122,136,258
4031,5223028816,671,6,117,128,245
4032,5223028944,672,1,135,128,263
4033,5223028944,672,2,132,113,245
4034,5223028944,672,3,125,119,244
4035,5223028944,672,4,131,130,261
4036,5223028944,672,5,121,125,246
4037,5223028944,672,6,114,127,241
4038,5223029072,673,1,129,125,254
4039,5223029072,673,2,137,122,259
4040,5223029072,673,3,130,120,250
4041,5223029072,673,4,124,118,242
4042,5223029072,673,5,124,130,254
4043,5223029072,673,6,114,127,241
4044,5223029200,674,1,118,139,257
4045,5223029200,674,2,125,127,252
4046,5223029200,674,3,126,113,239
4047,5223029200,674,4,120,135,255
4048,5223029200,674,5,131,115,246
4049,5223029200,674,6,138,113,251
4050,5223029456,675,1,139,112,251
4051,5223029456,675,2,111,133,244
4052,5223029456,675,3,118,127,245
4053,5223029456,675,4,122,139,261
4054,5223029456,675,5,133,109,242
4055,5223029456,675,6,135,122,257
4056,5223029584,676,1,119,128,247
4057,5223029584,676,2,112,132,244
4058,5223029584,676,3,130,123,253
4059,5223029584,676,4,117,123,240
4060,5223029584,676,5,141,112,253
4061,5223029584,676,6,139,124,263
4062,5223029712,677,1,117,129,246
4063,5223029712,677,2,118,134,252
4064,5223029712,677,3,130,120,250
4065,5223029712,677,4,109,129,238
4066,5223029712,677,5,142,118,260
4067,5223029712,677,6,142,112,254
4068,5223029840,678,1,109,130,239
4069,5223029840,678,2,126,133,259
4070,5223029840,678,3,130,120,250
4071,5223029840,678,4,109,129,238
4072,5223029840,678,5,142,118,260
4073,5223029840,678,6,142,112,254
4074,5223029968,679,1,109,130,239
4075,5223029968,679,2,128,135,263
4076,5223029968,679,3,127,119,246
4077,5223029968,679,4,112,130,242
4078,5223029968,679,5,137,113,250
4079,5223029968,679,6,145,115,260
4080,5223030096,680,1,126,117,243
4081,5223030096,680,2,122,127,249
4082,5223030096,680,3,126,129,255
4083,5223030096,680,4,133,121,254
4084,5223030096,680,5,118,122,240
4085,5223030096,680,6,133,126,259
4086,5223030224,681,1,117,133,250
4087,5223030224,681,2,132,128,260
4088,5223030224,681,3,120,122,242
4089,5223030224,681,4,130,132,262
4090,5223030224,681,5,133,114,247
4091,5223030224,681,6,126,113,239
4092,5223030352,682,1,117,133,250
4093,5223030352,682,2,122,125,247
4094,5223030352,682,3,120,122,242
4095,5223030352,682,4,130,132,262
4096,5223030352,682,5,133,114,247
4097,5223030352,682,6,136,116,252
4098,5223030480,683,1,117,133,250
4099,5223030480,683,2,139,120,259
4100,5223030480,683,3,114,136,250
4101,5223030480,683,4,131,121,252
4102,5223030480,683,5,139,112,251
4103,5223030480,683,6,118,120,238
4104,5223030608,684,1,136,101,237
4105,5223030608,684,2,133,130,263
4106,5223030608,684,3,108,130,238
4107,5223030608,684,4,128,123,251
4108,5223030608,684,5,127,128,255
4109,5223030608,684,6,126,130,256
4110,5223030736,685,1,128,113,241
4111,5223030736,685,2,133,118,251
4112,5223030736,685,3,124,127,251
4113,5223030736,685,4,138,121,259
4114,5223030736,685,5,110,137,247
4115,5223030736,685,6,125,126,251
4116,5225246864,686,1,127,125,252
4117,5225246864,686,2,122,125,247
4118,5225246864,686,3,119,132,251
4119,5225246864,686,4,130,114,244
4120,5225246864,686,5,126,119,245
4121,5225246864,686,6,134,127,261
4122,5225246992,687,1,138,115,253
4123,5225246992,687,2,122,125,247
4124,5225246992,687,3,109,131,240
4125,5225246992,687,4,116,130,246
4126,5225246992,687,5,129,128,257
4127,5225246992,687,6,144,113,257
4128,5225247120,688,1,114,127,241
4129,5225247120,688,2,140,110,250
4130,5225247120,688,3,120,134,254
4131,5225247120,688,4,140,120,260
4132,5225247120,688,5,127,121,248
4133,5225247120,688,6,117,130,247
4134,5225247248,689,1,125,134,259
4135,5225247248,689,2,131,108,239
4136,5225247248,689,3,119,143,262
4137,5225247248,689,4,134,110,244
4138,5225247248,689,5,131,113,244
4139,5225247248,689,6,118,134,252
4140,5225247376,690,1,116,123,239
4141,5225247376,690,2,139,113,252
4142,5225247376,690,3,119,143,262
4143,5225247376,690,4,131,111,242
4144,5225247376,690,5,138,121,259
4145,5225247376,690,6,115,131,246
4146,5225247504,691,1,113,149,262
4147,5225247504,691,2,134,111,245
4148,5225247504,691,3,144,115,259
4149,5225247504,691,4,122,121,243
4150,5225247504,691,5,134,113,247
4151,5225247504,691,6,111,133,244
4152,5225247632,692,1,108,143,251
4153,5225247632,692,2,124,123,247
4154,5225247632,692,3,144,113,257
4155,5225247632,692,4,120,117,237
4156,5225247632,692,5,136,124,260
4157,5225247632,692,6,126,122,248
4158,5225247760,693,1,120,124,244
4159,5225247760,693,2,139,116,255
4160,5225247760,693,3,130,110,240
4161,5225247760,693,4,123,129,252
4162,5225247760,693,5,124,127,251
4163,5225247760,693,6,122,136,258
4164,5225247888,694,1,123,139,262
4165,5225247888,694,2,129,121,250
4166,5225247888,694,3,134,106,240
4167,5225247888,694,4,125,123,248
4168,5225247888,694,5,125,122,247
4169,5225247888,694,6,122,131,253
4170,5225248016,695,1,121,134,255
4171,5225248016,695,2,133,127,260
4172,5225248016,695,3,142,116,258
4173,5225248016,695,4,119,121,240
4174,5225248016,695,5,122,115,237
4175,5225248016,695,6,121,129,250
4176,5225248144,696,1,112,135,247
4177,5225248144,696,2,129,128,257
4178,5225248144,696,3,145,114,259
4179,5225248144,696,4,128,120,248
4180,5225248144,696,5,126,122,248
4181,5225248144,696,6,118,123,241
4182,5225248272,697,1,123,130,253
4183,5225248272,697,2,127,110,237
4184,5225248272,697,3,145,118,263
4185,5225248272,697,4,127,115,242
4186,5225248272,697,5,120,139,259
4187,5225248272,697,6,116,130,246
4188,5225248400,698,1,119,132,251
4189,5225248400,698,2,138,114,252
4190,5225248400,698,3,133,107,240
4191,5225248400,698,4,127,117,244
4192,5225248400,698,5,117,140,257
4193,5225248400,698,6,124,132,256
4194,5225248528,699,1,113,150,263
4195,5225248528,699,2,137,124,261
4196,5225248528,699,3,140,113,253
4197,5225248528,699,4,125,113,238
4198,5225248528,699,5,124,114,238
4199,5225248528,699,6,119,128,247
4200,5225248656,700,1,111,144,255
4201,5225248656,700,2,135,122,257
4202,5225248656,700,3,147,106,253
4203,5225248656,700,4,120,118,238
4204,5225248656,700,5,124,117,241
4205,5225248656,700,6,121,135,256
4206,5225249040,701,1,126,136,262
4207,5225249040,701,2,124,118,242
4208,5225249040,701,3,130,108,238
4209,5225249040,701,4,129,120,249
4210,5225249040,701,5,121,131,252
4211,5225249040,701,6,128,129,257
4212,5225249168,702,1,132,119,251
4213,5225249168,702,2,140,119,259
4214,5225249168,702,3,136,107,243
4215,5225249168,702,4,122,137,259
4216,5225249168,702,5,117,127,244
4217,5225249168,702,6,111,133,244
4218,5225249296,703,1,120,123,243
4219,5225249296,703,2,129,119,248
4220,5225249296,703,3,129,121,250
4221,5225249296,703,4,122,137,259
4222,5225249296,703,5,135,126,261
4223,5225249296,703,6,123,116,239
4224,5225249424,704,1,122,124,246
4225,5225249424,704,2,147,116,263
4226,5225249424,704,3,119,128,247
4227,5225249424,704,4,114,134,248
4228,5225249424,704,5,128,119,247
4229,5225249424,704,6,128,121,249
4230,5225249680,705,1,122,124,246
4231,5225249680,705,2,146,116,262
4232,5225249680,705,3,119,128,247
4233,5225249680,705,4,114,134,248
4234,5225249680,705,5,130,120,250
4235,5225249680,705,6,127,120,247
4236,5225249808,706,1,126,134,260
4237,5225249808,706,2,138,101,239
4238,5225249808,706,3,122,130,252
4239,5225249808,706,4,123,140,263
4240,5225249808,706,5,119,127,246
4241,5225249808,706,6,130,110,240
4242,5225249936,707,1,126,134,260
4243,5225249936,707,2,138,101,239
4244,5225249936,707,3,122,130,252
4245,5225249936,707,4,111,129,240
4246,5225249936,707,5,119,127,246
4247,5225249936,707,6,142,121,263
4248,5225250064,708,1,139,114,253
4249,5225250064,708,2,142,115,257
4250,5225250064,708,3,121,133,254
4251,5225250064,708,4,112,137,249
4252,5225250064,708,5,118,131,249
4253,5225250064,708,6,126,112,238
4254,5225250192,709,1,128,118,246
4255,5225250192,709,2,129,113,242
4256,5225250192,709,3,119,141,260
4257,5225250192,709,4,126,129,255
4258,5225250192,709,5,127,113,240
4259,5225250192,709,6,129,128,257
4260,5225250320,710,1,120,126,246
4261,5225250320,710,2,122,125,247
4262,5225250320,710,3,119,127,246
4263,5225250320,710,4,125,130,255
4264,5225250320,710,5,151,110,261
4265,5225250320,710,6,121,124,245
4266,5225250448,711,1,121,134,255
4267,5225250448,711,2,123,117,240
4268,5225250448,711,3,125,125,250
4269,5225250448,711,4,120,117,237
4270,5225250448,711,5,143,119,262
4271,5225250448,711,6,126,130,256
4272,5225250576,712,1,121,134,255
4273,5225250576,712,2,123,117,240
4274,5225250576,712,3,122,121,243
4275,5225250576,712,4,123,121,244
4276,5225250576,712,5,143,119,262
4277,5225250576,712,6,126,130,256
4278,5225250704,713,1,135,128,263
4279,5225250704,713,2,122,125,247
4280,5225250704,713,3,114,140,254
4281,5225250704,713,4,127,122,249
4282,5225250704,713,5,140,106,246
4283,5225250704,713,6,120,121,241
4284,5227479120,714,1,129,120,249
4285,5227479120,714,2,126,128,254
4286,5227479120,714,3,131,127,258
4287,5227479120,714,4,113,136,249
4288,5227479120,714,5,141,108,249
4289,5227479120,714,6,118,123,241
4290,5227479248,715,1,128,124,252
4291,5227479248,715,2,113,126,239
4292,5227479248,715,3,122,127,249
4293,5227479248,715,4,125,135,260
4294,5227479248,715,5,135,103,238
4295,5227479248,715,6,135,127,262
4296,5227479376,716,1,123,119,242
4297,5227479376,716,2,135,121,256
4298,5227479376,716,3,109,130,239
4299,5227479376,716,4,130,128,258
4300,5227479376,716,5,125,118,243
4301,5227479376,716,6,136,126,262
4302,5227479504,717,1,123,119,242
4303,5227479504,717,2,135,121,256
4304,5227479504,717,3,109,130,239
4305,5227479504,717,4,126,121,247
4306,5227479504,717,5,129,125,254
4307,5227479504,717,6,136,126,262
4308,5227479632,718,1,123,117,240
4309,5227479632,718,2,137,109,246
4310,5227479632,718,3,124,134,258
4311,5227479632,718,4,118,123,241
4312,5227479632,718,5,131,129,260
4313,5227479632,718,6,125,130,255
4314,5227479760,719,1,122,126,248
4315,5227479760,719,2,145,118,263
4316,5227479760,719,3,116,133,249
4317,5227479760,719,4,108,130,238
4318,5227479760,719,5,131,130,261
4319,5227479760,719,6,136,105,241
4320,5227479888,720,1,119,126,245
4321,5227479888,720,2,129,113,242
4322,5227479888,720,3,136,109,245
4323,5227479888,720,4,126,127,253
4324,5227479888,720,5,137,126,263
4325,5227479888,720,6,111,141,252
4326,5227480016,721,1,122,126,248
4327,5227480016,721,2,129,113,242
4328,5227480016,721,3,136,109,245
4329,5227480016,721,4,126,127,253
4330,5227480016,721,5,134,126,260
4331,5227480016,721,6,111,141,252
4332,5227480144,722,1,117,127,244
4333,5227480144,722,2,131,126,257
4334,5227480144,722,3,135,106,241
4335,5227480144,722,4,131,125,256
4336,5227480144,722,5,134,125,259
4337,5227480144,722,6,110,133,243
4338,5227480272,723,1,132,128,260
4339,5227480272,723,2,137,111,248
4340,5227480272,723,3,117,123,240
4341,5227480272,723,4,110,140,250
4342,5227480272,723,5,131,119,250
4343,5227480272,723,6,131,121,252
4344,5227480400,724,1,132,128,260
4345,5227480400,724,2,137,111,248
4346,5227480400,724,3,117,123,240
4347,5227480400,724,4,114,147,261
4348,5227480400,724,5,131,119,250
4349,5227480400,724,6,127,114,241
4350,5227480528,725,1,127,110,237
4351,5227480528,725,2,142,117,259
4352,5227480528,725,3,117,129,246
4353,5227480528,725,4,121,132,253
4354,5227480528,725,5,122,132,254
4355,5227480528,725,6,129,122,251
4356,5227480656,726,1,134,110,244
4357,5227480656,726,2,145,118,263
4358,5227480656,726,3,122,134,256
4359,5227480656,726,4,113,127,240
4360,5227480656,726,5,115,131,246
4361,5227480656,726,6,129,122,251
4362,5227480784,727,1,133,129,262
4363,5227480784,727,2,141,114,255
4364,5227480784,727,3,128,126,254
4365,5227480784,727,4,114,131,245
4366,5227480784,727,5,121,123,244
4367,5227480784,727,6,121,119,240
4368,5227480912,728,1,138,114,252
4369,5227480912,728,2,119,126,245
4370,5227480912,728,3,109,138,247
4371,5227480912,728,4,134,125,259
4372,5227480912,728,5,126,118,244
4373,5227480912,728,6,132,121,253
4374,5227481040,729,1,135,119,254
4375,5227481040,729,2,118,119,237
4376,5227481040,729,3,109,138,247
4377,5227481040,729,4,129,130,259
4378,5227481040,729,5,130,120,250
4379,5227481040,729,6,137,116,253
4380,5227481168,730,1,130,108,238
4381,5227481168,730,2,123,130,253
4382,5227481168,730,3,112,130,242
4383,5227481168,730,4,120,132,252
4384,5227481168,730,5,138,124,262
4385,5227481168,730,6,135,118,253
4386,5227481296,731,1,141,116,257
4387,5227481296,731,2,123,130,253
4388,5227481296,731,3,112,130,242
4389,5227481296,731,4,113,124,237
4390,5227481296,731,5,138,124,262
4391,5227481296,731,6,131,118,249
4392,5227481424,732,1,131,122,253
4393,5227481424,732,2,122,128,250
4394,5227481424,732,3,130,129,259
4395,5227481424,732,4,113,136,249
4396,5227481424,732,5,127,120,247
4397,5227481424,732,6,135,107,242
4398,5227481552,733,1,123,121,244
4399,5227481552,733,2,119,126,245
4400,5227481552,733,3,119,135,254
4401,5227481552,733,4,132,125,257
4402,5227481552,733,5,132,128,260
4403,5227481552,733,6,133,107,240
4404,5227481808,734,1,133,117,250
4405,5227481808,734,2,119,126,245
4406,5227481808,734,3,122,139,261
4407,5227481808,734,4,118,128,246
4408,5227481808,734,5,126,120,246
4409,5227481808,734,6,140,112,252
4410,5227481936,735,1,133,117,250
4411,5227481936,735,2,119,126,245
4412,5227481936,735,3,123,137,260
4413,5227481936,735,4,117,130,247
4414,5227481936,735,5,126,120,246
4415,5227481936,735,6,140,112,252
4416,5227482064,736,1,137,117,254
4417,5227482064,736,2,117,130,247
4418,5227482064,736,3,113,126,239
4419,5227482064,736,4,120,133,253
4420,5227482064,736,5,125,119,244
4421,5227482064,736,6,146,117,263
4422,5227482192,737,1,136,120,256
4423,5227482192,737,2,119,126,245
4424,5227482192,737,3,116,123,239
4425,5227482192,737,4,114,134,248
4426,5227482192,737,5,134,124,258
4427,5227482192,737,6,139,115,254
4428,5227482320,738,1,118,131,249
4429,5227482320,738,2,113,126,239
4430,5227482320,738,3,133,129,262
4431,5227482320,738,4,118,123,241
4432,5227482320,738,5,136,116,252
4433,5227482320,738,6,140,117,257
4434,5227482448,739,1,123,119,242
4435,5227482448,739,2,119,126,245
4436,5227482448,739,3,124,137,261
4437,5227482448,739,4,131,117,248
4438,5227482448,739,5,132,111,243
4439,5227482448,739,6,129,132,261
4440,5227482704,740,1,143,117,260
4441,5227482704,740,2,119,126,245
4442,5227482704,740,3,117,133,250
4443,5227482704,740,4,115,128,243
4444,5227482704,740,5,136,105,241
4445,5227482704,740,6,128,133,261
4446,5227482832,741,1,135,126,261
4447,5227482832,741,2,125,126,251
4448,5227482832,741,3,128,113,241
4449,5227482832,741,4,110,134,244
4450,5227482832,741,5,133,118,251
4451,5227482832,741,6,127,125,252
4452,5227482960,742,1,137,114,251
4453,5227482960,742,2,111,133,244
4454,5227482960,742,3,119,134,253
4455,5227482960,742,4,115,125,240
4456,5227482960,742,5,146,107,253
4457,5227482960,742,6,130,129,259
4458,5227483088,743,1,140,106,246
4459,5227483088,743,2,121,129,250
4460,5227483088,743,3,126,137,263
4461,5227483088,743,4,119,124,243
4462,5227483088,743,5,136,125,261
4463,5227483088,743,6,116,121,237
4464,5229695120,744,1,140,115,255
4465,5229695120,744,2,135,114,249
4466,5229695120,744,3,117,133,250
4467,5229695120,744,4,117,133,250
4468,5229695120,744,5,126,116,242
4469,5229695120,744,6,123,131,254
4470,5229695248,745,1,119,134,253
4471,5229695248,745,2,126,134,260
4472,5229695248,745,3,140,103,243
4473,5229695248,745,4,121,135,256
4474,5229695248,745,5,130,118,248
4475,5229695248,745,6,122,118,240
4476,5229695376,746,1,132,116,248
4477,5229695376,746,2,129,128,257
4478,5229695376,746,3,120,136,256
4479,5229695376,746,4,113,132,245
4480,5229695376,746,5,132,121,253
4481,5229695376,746,6,132,109,241
4482,5229695504,747,1,127,128,255
4483,5229695504,747,2,120,131,251
4484,5229695504,747,3,138,103,241
4485,5229695504,747,4,116,131,247
4486,5229695504,747,5,127,120,247
4487,5229695504,747,6,130,129,259
4488,5229695632,748,1,131,127,258
4489,5229695632,748,2,140,104,244
4490,5229695632,748,3,113,137,250
4491,5229695632,748,4,122,128,250
4492,5229695632,748,5,117,127,244
4493,5229695632,748,6,135,119,254
4494,5229695888,749,1,127,120,247
4495,5229695888,749,2,136,107,243
4496,5229695888,749,3,118,140,258
4497,5229695888,749,4,111,130,241
4498,5229695888,749,5,127,128,255
4499,5229695888,749,6,139,117,256
4500,5229696016,750,1,129,112,241
4501,5229696016,750,2,144,115,259
4502,5229696016,750,3,125,135,260
4503,5229696016,750,4,122,118,240
4504,5229696016,750,5,116,134,250
4505,5229696016,750,6,122,128,250
4506,5229696144,751,1,136,121,257
4507,5229696144,751,2,136,105,241
4508,5229696144,751,3,124,128,252
4509,5229696144,751,4,132,127,259
4510,5229696144,751,5,113,126,239
4511,5229696144,751,6,117,135,252
4512,5229696272,752,1,138,121,259
4513,5229696272,752,2,143,106,249
4514,5229696272,752,3,120,123,243
4515,5229696272,752,4,130,126,256
4516,5229696272,752,5,119,136,255
4517,5229696272,752,6,108,130,238
4518,5229696400,753,1,138,121,259
4519,5229696400,753,2,143,106,249
4520,5229696400,753,3,120,123,243
4521,5229696400,753,4,125,119,244
4522,5229696400,753,5,119,136,255
4523,5229696400,753,6,113,137,250
4524,5229696528,754,1,125,114,239
4525,5229696528,754,2,134,115,249
4526,5229696528,754,3,117,138,255
4527,5229696528,754,4,135,115,250
4528,5229696528,754,5,129,134,263
4529,5229696528,754,6,118,126,244
4530,5229696656,755,1,134,126,260
4531,5229696656,755,2,134,115,249
4532,5229696656,755,3,110,128,238
4533,5229696656,755,4,135,115,250
4534,5229696656,755,5,127,132,259
4535,5229696656,755,6,118,126,244
4536,5229696912,756,1,122,128,250
4537,5229696912,756,2,117,143,260
4538,5229696912,756,3,133,129,262
4539,5229696912,756,4,124,125,249
4540,5229696912,756,5,138,103,241
4541,5229696912,756,6,124,114,238
4542,5229697040,757,1,111,133,244
4543,5229697040,757,2,130,131,261
4544,5229697040,757,3,142,120,262
4545,5229697040,757,4,113,133,246
4546,5229697040,757,5,138,99,237
4547,5229697040,757,6,124,126,250
4548,5229697168,758,1,138,109,247
4549,5229697168,758,2,130,118,248
4550,5229697168,758,3,129,128,257
4551,5229697168,758,4,116,142,258
4552,5229697168,758,5,121,117,238
4553,5229697168,758,6,124,128,252
4554,5229697296,759,1,135,127,262
4555,5229697296,759,2,133,130,263
4556,5229697296,759,3,119,126,245
4557,5229697296,759,4,110,128,238
4558,5229697296,759,5,121,119,240
4559,5229697296,759,6,140,112,252
4560,5229697424,760,1,133,113,246
4561,5229697424,760,2,126,124,250
4562,5229697424,760,3,124,131,255
4563,5229697424,760,4,123,132,255
4564,5229697424,760,5,118,132,250
4565,5229697424,760,6,134,110,244
4566,5229697552,761,1,151,112,263
4567,5229697552,761,2,130,132,262
4568,5229697552,761,3,121,118,239
4569,5229697552,761,4,110,137,247
4570,5229697552,761,5,120,123,243
4571,5229697552,761,6,126,120,246
4572,5229697680,762,1,131,117,248
4573,5229697680,762,2,133,111,244
4574,5229697680,762,3,132,130,262
4575,5229697680,762,4,126,128,254
4576,5229697680,762,5,115,133,248
4577,5229697680,762,6,121,123,244
4578,5229697808,763,1,115,124,239
4579,5229697808,763,2,145,113,258
4580,5229697808,763,3,129,119,248
4581,5229697808,763,4,139,124,263
4582,5229697808,763,5,114,137,251
4583,5229697808,763,6,116,125,241
4584,5229697936,764,1,138,103,241
4585,5229697936,764,2,127,128,255
4586,5229697936,764,3,118,134,252
4587,5229697936,764,4,112,130,242
4588,5229697936,764,5,122,137,259
4589,5229697936,764,6,141,110,251
4590,5229698064,765,1,146,104,250
4591,5229698064,765,2,127,128,255
4592,5229698064,765,3,121,139,260
4593,5229698064,765,4,111,129,240
4594,5229698064,765,5,116,128,244
4595,5229698064,765,6,137,114,251
4596,5229698192,766,1,146,104,250
4597,5229698192,766,2,123,121,244
4598,5229698192,766,3,121,139,260
4599,5229698192,766,4,111,129,240
4600,5229698192,766,5,120,135,255
4601,5229698192,766,6,137,114,251
4602,5229698576,767,1,123,123,246
4603,5229698576,767,2,132,115,247
4604,5229698576,767,3,130,123,253
4605,5229698576,767,4,122,134,256
4606,5229698576,767,5,116,122,238
4607,5229698576,767,6,135,125,260
4608,5229698704,768,1,115,131,246
4609,5229698704,768,2,122,129,251
4610,5229698704,768,3,136,120,256
4611,5229698704,768,4,133,113,246
4612,5229698704,768,5,122,140,262
4613,5229698704,768,6,130,109,239
4614,5229698832,769,1,115,131,246
4615,5229698832,769,2,122,129,251
4616,5229698832,769,3,136,120,256
4617,5229698832,769,4,133,113,246
4618,5229698832,769,5,114,133,247
4619,5229698832,769,6,138,116,254
4620,5229698960,770,1,122,141,263
4621,5229698960,770,2,122,129,251
4622,5229698960,770,3,129,110,239
4623,5229698960,770,4,133,113,246
4624,5229698960,770,5,114,133,247
4625,5229698960,770,6,138,116,254
4626,5231927376,771,1,122,141,263
4627,5231927376,771,2,119,120,239
4628,5231927376,771,3,129,110,239
4629,5231927376,771,4,136,122,258
4630,5231927376,771,5,114,133,247
4631,5231927376,771,6,138,116,254
4632,5231927504,772,1,112,132,244
4633,5231927504,772,2,119,120,239
4634,5231927504,772,3,141,121,262
4635,5231927504,772,4,136,122,258
4636,5231927504,772,5,117,129,246
4637,5231927504,772,6,133,118,251
4638,5231927632,773,1,129,122,251
4639,5231927632,773,2,120,135,255
4640,5231927632,773,3,123,128,251
4641,5231927632,773,4,144,104,248
4642,5231927632,773,5,118,133,251
4643,5231927632,773,6,124,120,244
4644,5231927760,774,1,133,127,260
4645,5231927760,774,2,112,131,243
4646,5231927760,774,3,125,127,252
4647,5231927760,774,4,136,107,243
4648,5231927760,774,5,129,132,261
4649,5231927760,774,6,123,118,241
4650,5231927888,775,1,128,121,249
4651,5231927888,775,2,119,141,260
4652,5231927888,775,3,133,113,246
4653,5231927888,775,4,122,127,249
4654,5231927888,775,5,141,115,256
4655,5231927888,775,6,115,125,240
4656,5231928016,776,1,131,123,254
4657,5231928016,776,2,119,122,241
4658,5231928016,776,3,135,116,251
4659,5231928016,776,4,127,129,256
4660,5231928016,776,5,128,122,250
4661,5231928016,776,6,118,130,248
4662,5231928144,777,1,129,122,251
4663,5231928144,777,2,126,112,238
4664,5231928144,777,3,132,116,248
4665,5231928144,777,4,129,131,260
4666,5231928144,777,5,119,130,249
4667,5231928144,777,6,123,131,254
4668,5231928272,778,1,128,115,243
4669,5231928272,778,2,134,120,254
4670,5231928272,778,3,143,105,248
4671,5231928272,778,4,122,137,259
4672,5231928272,778,5,116,140,256
4673,5231928272,778,6,115,125,240
4674,5231928400,779,1,121,117,238
4675,5231928400,779,2,121,133,254
4676,5231928400,779,3,148,113,261
4677,5231928400,779,4,123,116,239
4678,5231928400,779,5,110,135,245
4679,5231928400,779,6,135,128,263
4680,5231928528,780,1,120,129,249
4681,5231928528,780,2,117,140,257
4682,5231928528,780,3,122,118,240
4683,5231928528,780,4,143,108,251
4684,5231928528,780,5,115,133,248
4685,5231928528,780,6,141,114,255
4686,5231928656,781,1,116,127,243
4687,5231928656,781,2,116,123,239
4688,5231928656,781,3,142,119,261
4689,5231928656,781,4,122,141,263
4690,5231928656,781,5,134,105,239
4691,5231928656,781,6,128,127,255
4692,5231928784,782,1,119,126,245
4693,5231928784,782,2,124,137,261
4694,5231928784,782,3,134,105,239
4695,5231928784,782,4,122,141,263
4696,5231928784,782,5,131,106,237
4697,5231928784,782,6,128,127,255
4698,5231928912,783,1,113,126,239
4699,5231928912,783,2,131,121,252
4700,5231928912,783,3,137,103,240
4701,5231928912,783,4,113,150,263
4702,5231928912,783,5,136,121,257
4703,5231928912,783,6,128,121,249
4704,5231929040,784,1,113,126,239
4705,5231929040,784,2,121,135,256
4706,5231929040,784,3,146,117,263
4707,5231929040,784,4,112,127,239
4708,5231929040,784,5,136,121,257
4709,5231929040,784,6,130,116,246
4710,5231929296,785,1,128,128,256
4711,5231929296,785,2,131,130,261
4712,5231929296,785,3,131,120,251
4713,5231929296,785,4,120,121,241
4714,5231929296,785,5,140,113,253
4715,5231929296,785,6,108,130,238
4716,5231929424,786,1,134,114,248
4717,5231929424,786,2,123,139,262
4718,5231929424,786,3,115,134,249
4719,5231929424,786,4,140,108,248
4720,5231929424,786,5,120,122,242
4721,5231929424,786,6,126,125,251
4722,5231929552,787,1,122,132,254
4723,5231929552,787,2,113,137,250
4724,5231929552,787,3,131,110,241
4725,5231929552,787,4,125,131,256
4726,5231929552,787,5,132,116,248
4727,5231929552,787,6,135,116,251
4728,5231929680,788,1,119,123,242
4729,5231929680,788,2,120,143,263
4730,5231929680,788,3,139,124,263
4731,5231929680,788,4,121,125,246
4732,5231929680,788,5,127,111,238
4733,5231929680,788,6,132,116,248
4734,5231929808,789,1,123,130,253
4735,5231929808,789,2,122,133,255
4736,5231929808,789,3,117,123,240
4737,5231929808,789,4,119,129,248
4738,5231929808,789,5,133,120,253
4739,5231929808,789,6,144,107,251
4740,5231929936,790,1,113,126,239
4741,5231929936,790,2,131,108,239
4742,5231929936,790,3,136,121,257
4743,5231929936,790,4,142,114,256
4744,5231929936,790,5,120,141,261
4745,5231929936,790,6,116,132,248
4746,5231930064,791,1,113,126,239
4747,5231930064,791,2,143,119,262
4748,5231930064,791,3,136,121,257
4749,5231930064,791,4,142,114,256
4750,5231930064,791,5,108,130,238
4751,5231930064,791,6,116,132,248
4752,5231930192,792,1,113,126,239
4753,5231930192,792,2,141,112,253
4754,5231930192,792,3,135,122,257
4755,5231930192,792,4,122,140,262
4756,5231930192,792,5,129,122,251
4757,5231930192,792,6,118,120,238
4758,5231930320,793,1,117,127,244
4759,5231930320,793,2,133,104,237
4760,5231930320,793,3,130,125,255
4761,5231930320,793,4,122,137,259
4762,5231930320,793,5,134,120,254
4763,5231930320,793,6,122,129,251
4764,5231930448,794,1,117,127,244
4765,5231930448,794,2,144,112,256
4766,5231930448,794,3,130,125,255
4767,5231930448,794,4,115,129,244
4768,5231930448,794,5,130,120,250
4769,5231930448,794,6,122,129,251
4770,5231930576,795,1,117,127,244
4771,5231930576,795,2,144,112,256
4772,5231930576,795,3,130,125,255
4773,5231930576,795,4,119,136,255
4774,5231930576,795,5,126,113,239
4775,5231930576,795,6,122,129,251
4776,5231930704,796,1,133,115,248
4777,5231930704,796,2,139,118,257
4778,5231930704,796,3,117,127,244
4779,5231930704,796,4,114,132,246
4780,5231930704,796,5,126,137,263
4781,5231930704,796,6,129,113,242
4782,5231930832,797,1,131,108,239
4783,5231930832,797,2,138,121,259
4784,5231930832,797,3,118,134,252
4785,5231930832,797,4,116,133,249
4786,5231930832,797,5,125,132,257
4787,5231930832,797,6,130,114,244
4788,5231930960,798,1,126,134,260
4789,5231930960,798,2,144,105,249
4790,5231930960,798,3,121,118,239
4791,5231930960,798,4,131,132,263
4792,5231930960,798,5,115,133,248
4793,5231930960,798,6,121,120,241
4794,5231931088,799,1,115,123,238
4795,5231931088,799,2,144,105,249
4796,5231931088,799,3,132,129,261
4797,5231931088,799,4,131,132,263
4798,5231931088,799,5,115,133,248
4799,5231931088,799,6,121,120,241
4800,5231931216,800,1,118,128,246
4801,5231931216,800,2,148,111,259
4802,5231931216,800,3,131,123,254
4803,5231931216,800,4,116,139,255
4804,5231931216,800,5,125,112,237
4805,5231931216,800,6,120,129,249
4806,5231931344,801,1,122,141,263
4807,5231931344,801,2,143,104,247
4808,5231931344,801,3,129,115,244
4809,5231931344,801,4,110,139,249
4810,5231931344,801,5,131,127,258
4811,5231931344,801,6,123,116,239
4812,5234139280,802,1,115,131,246
4813,5234139280,802,2,138,109,247
4814,5234139280,802,3,136,115,251
4815,5234139280,802,4,113,128,241
4816,5234139280,802,5,122,132,254
4817,5234139280,802,6,134,127,261
4818,5234139408,803,1,118,134,252
4819,5234139408,803,2,145,116,261
4820,5234139408,803,3,132,118,250
4821,5234139408,803,4,115,129,244
4822,5234139408,803,5,120,133,253
4823,5234139408,803,6,128,112,240
4824,5234139536,804,1,115,131,246
4825,5234139536,804,2,136,107,243
4826,5234139536,804,3,129,115,244
4827,5234139536,804,4,118,133,251
4828,5234139536,804,5,120,136,256
4829,5234139536,804,6,140,120,260
4830,5234139664,805,1,113,126,239
4831,5234139664,805,2,134,121,255
4832,5234139664,805,3,140,114,254
4833,5234139664,805,4,121,132,253
4834,5234139664,805,5,126,132,258
4835,5234139664,805,6,124,117,241
4836,5234139792,806,1,119,126,245
4837,5234139792,806,2,129,128,257
4838,5234139792,806,3,131,110,241
4839,5234139792,806,4,122,127,249
4840,5234139792,806,5,124,129,253
4841,5234139792,806,6,133,122,255
4842,5234139920,807,1,129,128,257
4843,5234139920,807,2,128,122,250
4844,5234139920,807,3,145,117,262
4845,5234139920,807,4,135,114,249
4846,5234139920,807,5,108,129,237
4847,5234139920,807,6,113,132,245
4848,5234140176,808,1,113,126,239
4849,5234140176,808,2,134,124,258
4850,5234140176,808,3,137,109,246
4851,5234140176,808,4,118,128,246
4852,5234140176,808,5,130,133,263
4853,5234140176,808,6,126,122,248
4854,5234140304,809,1,113,126,239
4855,5234140304,809,2,134,124,258
4856,5234140304,809,3,148,112,260
4857,5234140304,809,4,116,123,239
4858,5234140304,809,5,112,130,242
4859,5234140304,809,6,135,127,262
4860,5234140432,810,1,113,126,239
4861,5234140432,810,2,134,124,258
4862,5234140432,810,3,140,107,247
4863,5234140432,810,4,127,129,256
4864,5234140432,810,5,122,141,263
4865,5234140432,810,6,122,115,237
4866,5234140560,811,1,119,126,245
4867,5234140560,811,2,129,128,257
4868,5234140560,811,3,141,107,248
4869,5234140560,811,4,114,137,251
4870,5234140560,811,5,120,133,253
4871,5234140560,811,6,135,111,246
4872,5234140688,812,1,119,126,245
4873,5234140688,812,2,132,130,262
4874,5234140688,812,3,138,105,243
4875,5234140688,812,4,114,137,251
4876,5234140688,812,5,120,133,253
4877,5234140688,812,6,135,111,246
4878,5234140816,813,1,119,126,245
4879,5234140816,813,2,132,128,260
4880,5234140816,813,3,138,105,243
4881,5234140816,813,4,118,133,251
4882,5234140816,813,5,120,135,255
4883,5234140816,813,6,131,115,246
4884,5234140944,814,1,119,126,245
4885,5234140944,814,2,132,128,260
4886,5234140944,814,3,138,105,243
4887,5234140944,814,4,118,128,246
4888,5234140944,814,5,119,134,253
4889,5234140944,814,6,132,121,253
4890,5234141072,815,1,119,126,245
4891,5234141072,815,2,132,128,260
4892,5234141072,815,3,138,105,243
4893,5234141072,815,4,123,135,258
4894,5234141072,815,5,119,134,253
4895,5234141072,815,6,127,114,241
4896,5234141200,816,1,119,126,245
4897,5234141200,816,2,123,122,245
4898,5234141200,816,3,138,107,245
4899,5234141200,816,4,125,125,250
4900,5234141200,816,5,130,124,254
4901,5234141200,816,6,123,138,261
4902,5234141328,817,1,121,118,239
4903,5234141328,817,2,126,131,257
4904,5234141328,817,3,144,112,256
4905,5234141328,817,4,110,140,250
4906,5234141328,817,5,137,123,260
4907,5234141328,817,6,120,118,238
4908,5234141456,818,1,121,118,239
4909,5234141456,818,2,126,131,257
4910,5234141456,818,3,144,112,256
4911,5234141456,818,4,106,140,246
4912,5234141456,818,5,134,114,248
4913,5234141456,818,6,127,127,254
4914,5234141584,819,1,133,122,255
4915,5234141584,819,2,115,126,241
4916,5234141584,819,3,137,115,252
4917,5234141584,819,4,123,128,251
4918,5234141584,819,5,111,129,240
4919,5234141584,819,6,139,122,261
4920,5234141712,820,1,135,123,258
4921,5234141712,820,2,130,113,243
4922,5234141712,820,3,134,114,248
4923,5234141712,820,4,116,133,249
4924,5234141712,820,5,117,140,257
4925,5234141712,820,6,126,119,245
4926,5234141840,821,1,136,109,245
4927,5234141840,821,2,113,126,239
4928,5234141840,821,3,138,123,261
4929,5234141840,821,4,148,112,260
4930,5234141840,821,5,114,141,255
4931,5234141840,821,6,109,131,240
4932,5234141968,822,1,125,119,244
4933,5234141968,822,2,122,141,263
4934,5234141968,822,3,128,111,239
4935,5234141968,822,4,145,103,248
4936,5234141968,822,5,114,140,254
4937,5234141968,822,6,124,128,252
4938,5234142096,823,1,133,129,262
4939,5234142096,823,2,138,104,242
4940,5234142096,823,3,135,120,255
4941,5234142096,823,4,111,136,247
4942,5234142096,823,5,123,125,248
4943,5234142096,823,6,118,128,246
4944,5234142224,824,1,133,129,262
4945,5234142224,824,2,138,104,242
4946,5234142224,824,3,135,120,255
4947,5234142224,824,4,111,136,247
4948,5234142224,824,5,117,121,238
4949,5234142224,824,6,124,132,256
4950,5234142352,825,1,128,118,246
4951,5234142352,825,2,127,114,241
4952,5234142352,825,3,125,136,261
4953,5234142352,825,4,116,133,249
4954,5234142352,825,5,137,109,246
4955,5234142352,825,6,125,132,257
4956,5234142480,826,1,141,117,258
4957,5234142480,826,2,124,129,253
4958,5234142480,826,3,111,133,244
4959,5234142480,826,4,116,123,239
4960,5234142480,826,5,140,110,250
4961,5234142480,826,6,126,130,256
4962,5234142608,827,1,141,117,258
4963,5234142608,827,2,117,121,238
4964,5234142608,827,3,111,133,244
4965,5234142608,827,4,123,131,254
4966,5234142608,827,5,140,110,250
4967,5234142608,827,6,126,130,256
4968,5234142864,828,1,129,111,240
4969,5234142864,828,2,124,129,253
4970,5234142864,828,3,123,139,262
4971,5234142864,828,4,116,123,239
4972,5234142864,828,5,140,110,250
4973,5234142864,828,6,126,130,256
4974,5234142992,829,1,129,111,240
4975,5234142992,829,2,124,129,253
4976,5234142992,829,3,123,139,262
4977,5234142992,829,4,123,135,258
4978,5234142992,829,5,140,110,250
4979,5234142992,829,6,119,118,237
4980,5234143120,830,1,127,110,237
4981,5234143120,830,2,125,138,263
4982,5234143120,830,3,111,133,244
4983,5234143120,830,4,118,144,262
4984,5234143120,830,5,137,100,237
4985,5234143120,830,6,140,117,257
4986,5236379728,831,1,125,117,242
4987,5236379728,831,2,122,134,256
4988,5236379728,831,3,123,139,262
4989,5236379728,831,4,110,132,242
4990,5236379728,831,5,141,105,246
4991,5236379728,831,6,137,115,252
4992,5236379856,832,1,134,128,262
4993,5236379856,832,2,122,134,256
4994,5236379856,832,3,114,128,242
4995,5236379856,832,4,110,132,242
4996,5236379856,832,5,141,105,246
4997,5236379856,832,6,137,115,252
4998,5236380112,833,1,124,128,252
4999,5236380112,833,2,122,138,260
5000,5236380112,833,3,123,117,240
5001,5236380112,833,4,114,133,247
5002,5236380112,833,5,135,114,249
5003,5236380112,833,6,140,112,252
5004,5236380240,834,1,122,127,249
5005,5236380240,834,2,122,138,260
5006,5236380240,834,3,125,118,243
5007,5236380240,834,4,114,133,247
5008,5236380240,834,5,135,114,249
5009,5236380240,834,6,140,112,252
5010,5236380368,835,1,137,106,243
5011,5236380368,835,2,110,139,249
5012,5236380368,835,3,113,126,239
5013,5236380368,835,4,125,133,258
5014,5236380368,835,5,130,121,251
5015,5236380368,835,6,143,117,260
5016,5236380496,836,1,143,106,249
5017,5236380496,836,2,113,141,254
5018,5236380496,836,3,125,115,240
5019,5236380496,836,4,135,126,261
5020,5236380496,836,5,126,132,258
5021,5236380496,836,6,116,122,238
5022,5236380624,837,1,146,107,253
5023,5236380624,837,2,115,141,256
5024,5236380624,837,3,126,114,240
5025,5236380624,837,4,122,120,242
5026,5236380624,837,5,126,132,258
5027,5236380624,837,6,123,128,251
5028,5236380880,838,1,128,109,237
5029,5236380880,838,2,117,138,255
5030,5236380880,838,3,140,115,255
5031,5236380880,838,4,121,130,251
5032,5236380880,838,5,140,118,258
5033,5236380880,838,6,112,132,244
5034,5236381008,839,1,123,121,244
5035,5236381008,839,2,110,128,238
5036,5236381008,839,3,141,114,255
5037,5236381008,839,4,132,125,257
5038,5236381008,839,5,135,127,262
5039,5236381008,839,6,117,127,244
5040,5236381136,840,1,131,128,259
5041,5236381136,840,2,110,128,238
5042,5236381136,840,3,141,114,255
5043,5236381136,840,4,124,118,242
5044,5236381136,840,5,135,127,262
5045,5236381136,840,6,117,127,244
5046,5236381264,841,1,131,126,257
5047,5236381264,841,2,134,119,253
5048,5236381264,841,3,121,124,245
5049,5236381264,841,4,113,141,254
5050,5236381264,841,5,137,107,244
5051,5236381264,841,6,122,125,247
5052,5236381392,842,1,113,126,239
5053,5236381392,842,2,124,134,258
5054,5236381392,842,3,133,111,244
5055,5236381392,842,4,120,138,258
5056,5236381392,842,5,146,107,253
5057,5236381392,842,6,122,126,248
5058,5236381520,843,1,111,141,252
5059,5236381520,843,2,120,125,245
5060,5236381520,843,3,133,118,251
5061,5236381520,843,4,119,119,238
5062,5236381520,843,5,146,111,257
5063,5236381520,843,6,129,128,257
5064,5236381648,844,1,121,116,237
5065,5236381648,844,2,118,140,258
5066,5236381648,844,3,124,118,242
5067,5236381648,844,4,146,115,261
5068,5236381648,844,5,136,127,263
5069,5236381648,844,6,113,126,239
5070,5236381904,845,1,119,132,251
5071,5236381904,845,2,142,111,253
5072,5236381904,845,3,117,131,248
5073,5236381904,845,4,128,111,239
5074,5236381904,845,5,136,123,259
5075,5236381904,845,6,116,134,250
5076,5236382032,846,1,112,127,239
5077,5236382032,846,2,142,111,253
5078,5236382032,846,3,121,135,256
5079,5236382032,846,4,142,112,254
5080,5236382032,846,5,130,124,254
5081,5236382032,846,6,111,133,244
5082,5236382160,847,1,118,133,251
5083,5236382160,847,2,142,111,253
5084,5236382160,847,3,121,135,256
5085,5236382160,847,4,142,112,254
5086,5236382160,847,5,124,118,242
5087,5236382160,847,6,111,133,244
5088,5236382416,848,1,126,125,251
5089,5236382416,848,2,117,138,255
5090,5236382416,848,3,120,117,237
5091,5236382416,848,4,147,106,253
5092,5236382416,848,5,125,117,242
5093,5236382416,848,6,123,139,262
5094,5236382544,849,1,122,118,240
5095,5236382544,849,2,120,142,262
5096,5236382544,849,3,121,120,241
5097,5236382544,849,4,147,106,253
5098,5236382544,849,5,125,117,242
5099,5236382544,849,6,123,139,262
5100,5236382672,850,1,139,116,255
5101,5236382672,850,2,117,140,257
5102,5236382672,850,3,127,136,263
5103,5236382672,850,4,136,102,238
5104,5236382672,850,5,117,130,247
5105,5236382672,850,6,122,118,240
5106,5236382800,851,1,139,112,251
5107,5236382800,851,2,121,131,252
5108,5236382800,851,3,109,134,243
5109,5236382800,851,4,130,123,253
5110,5236382800,851,5,122,128,250
5111,5236382800,851,6,137,114,251
5112,5236382928,852,1,139,112,251
5113,5236382928,852,2,118,122,240
5114,5236382928,852,3,112,143,255
5115,5236382928,852,4,130,123,253
5116,5236382928,852,5,122,128,250
5117,5236382928,852,6,137,114,251
5118,5236383184,853,1,131,119,250
5119,5236383184,853,2,132,121,253
5120,5236383184,853,3,112,143,255
5121,5236383184,853,4,127,122,249
5122,5236383184,853,5,113,126,239
5123,5236383184,853,6,143,111,254
5124,5236383312,854,1,126,114,240
5125,5236383312,854,2,147,114,261
5126,5236383312,854,3,129,133,262
5127,5236383312,854,4,117,127,244
5128,5236383312,854,5,117,127,244
5129,5236383312,854,6,122,127,249
5130,5236383440,855,1,137,126,263
5131,5236383440,855,2,136,102,238
5132,5236383440,855,3,129,133,262
5133,5236383440,855,4,117,127,244
5134,5236383440,855,5,117,127,244
5135,5236383440,855,6,122,127,249
5136,5236383568,856,1,136,121,257
5137,5236383568,856,2,140,113,253
5138,5236383568,856,3,114,129,243
5139,5236383568,856,4,129,134,263
5140,5236383568,856,5,113,126,239
5141,5236383568,856,6,126,119,245
5142,5236383696,857,1,136,121,257
5143,5236383696,857,2,140,113,253
5144,5236383696,857,3,124,136,260
5145,5236383696,857,4,119,127,246
5146,5236383696,857,5,113,126,239
5147,5236383696,857,6,126,119,245
5148,5238583440,858,1,124,124,248
5149,5238583440,858,2,131,126,257
5150,5238583440,858,3,116,127,243
5151,5238583440,858,4,129,118,247
5152,5238583440,858,5,132,128,260
5153,5238583440,858,6,126,119,245
5154,5238583568,859,1,130,118,248
5155,5238583568,859,2,124,114,238
5156,5238583568,859,3,110,140,250
5157,5238583568,859,4,132,130,262
5158,5238583568,859,5,122,125,247
5159,5238583568,859,6,140,115,255
5160,5238583696,860,1,128,126,254
5161,5238583696,860,2,113,137,250
5162,5238583696,860,3,127,132,259
5163,5238583696,860,4,131,118,249
5164,5238583696,860,5,119,126,245
5165,5238583696,860,6,140,103,243
5166,5238583824,861,1,130,111,241
5167,5238583824,861,2,120,138,258
5168,5238583824,861,3,134,116,250
5169,5238583824,861,4,122,117,239
5170,5238583824,861,5,119,136,255
5171,5238583824,861,6,133,124,257
5172,5238583952,862,1,124,116,240
5173,5238583952,862,2,124,121,245
5174,5238583952,862,3,120,140,260
5175,5238583952,862,4,134,107,241
5176,5238583952,862,5,126,129,255
5177,5238583952,862,6,130,129,259
5178,5238584080,863,1,128,116,244
5179,5238584080,863,2,124,121,245
5180,5238584080,863,3,111,132,243
5181,5238584080,863,4,143,115,258
5182,5238584080,863,5,122,129,251
5183,5238584080,863,6,130,129,259
5184,5238584208,864,1,130,115,245
5185,5238584208,864,2,130,118,248
5186,5238584208,864,3,124,127,251
5187,5238584208,864,4,134,116,250
5188,5238584208,864,5,119,126,245
5189,5238584208,864,6,121,140,261
5190,5238584336,865,1,133,123,256
5191,5238584336,865,2,117,138,255
5192,5238584336,865,3,128,133,261
5193,5238584336,865,4,134,111,245
5194,5238584336,865,5,123,117,240
5195,5238584336,865,6,123,120,243
5196,5238584464,866,1,125,127,252
5197,5238584464,866,2,118,139,257
5198,5238584464,866,3,125,125,250
5199,5238584464,866,4,137,109,246
5200,5238584464,866,5,131,113,244
5201,5238584464,866,6,122,129,251
5202,5238584592,867,1,133,123,256
5203,5238584592,867,2,123,123,246
5204,5238584592,867,3,116,122,238
5205,5238584592,867,4,139,103,242
5206,5238584592,867,5,135,128,263
5207,5238584592,867,6,112,143,255
5208,5238584720,868,1,133,123,256
5209,5238584720,868,2,123,123,246
5210,5238584720,868,3,128,133,261
5211,5238584720,868,4,139,103,242
5212,5238584720,868,5,123,117,240
5213,5238584720,868,6,112,143,255
5214,5238584848,869,1,137,121,258
5215,5238584848,869,2,128,132,260
5216,5238584848,869,3,132,115,247
5217,5238584848,869,4,126,122,248
5218,5238584848,869,5,111,133,244
5219,5238584848,869,6,124,119,243
5220,5238585104,870,1,123,138,261
5221,5238585104,870,2,137,106,243
5222,5238585104,870,3,122,125,247
5223,5238585104,870,4,122,141,263
5224,5238585104,870,5,121,124,245
5225,5238585104,870,6,133,108,241
5226,5238585232,871,1,123,138,261
5227,5238585232,871,2,137,106,243
5228,5238585232,871,3,122,125,247
5229,5238585232,871,4,112,130,242
5230,5238585232,871,5,121,124,245
5231,5238585232,871,6,143,119,262
5232,5238585360,872,1,123,138,261
5233,5238585360,872,2,137,106,243
5234,5238585360,872,3,122,125,247
5235,5238585360,872,4,116,132,248
5236,5238585360,872,5,121,124,245
5237,5238585360,872,6,139,117,256
5238,5238585488,873,1,118,122,240
5239,5238585488,873,2,147,113,260
5240,5238585488,873,3,122,128,250
5241,5238585488,873,4,118,139,257
5242,5238585488,873,5,127,114,241
5243,5238585488,873,6,126,126,252
5244,5238585616,874,1,110,127,237
5245,5238585616,874,2,146,110,256
5246,5238585616,874,3,122,128,250
5247,5238585616,874,4,110,128,238
5248,5238585616,874,5,134,124,258
5249,5238585616,874,6,136,125,261
5250,5238585744,875,1,137,124,261
5251,5238585744,875,2,142,112,254
5252,5238585744,875,3,121,123,244
5253,5238585744,875,4,107,132,239
5254,5238585744,875,5,129,122,251
5255,5238585744,875,6,122,129,251
5256,5238585872,876,1,125,119,244
5257,5238585872,876,2,145,112,257
5258,5238585872,876,3,124,123,247
5259,5238585872,876,4,124,135,259
5260,5238585872,876,5,121,126,247
5261,5238585872,876,6,119,127,246
5262,5238586000,877,1,134,113,247
5263,5238586000,877,2,109,130,239
5264,5238586000,877,3,129,128,257
5265,5238586000,877,4,136,124,260
5266,5238586000,877,5,133,118,251
5267,5238586000,877,6,117,129,246
5268,5238586128,878,1,126,135,261
5269,5238586128,878,2,111,133,244
5270,5238586128,878,3,134,111,245
5271,5238586128,878,4,133,113,246
5272,5238586128,878,5,130,115,245
5273,5238586128,878,6,124,135,259
5274,5238586256,879,1,122,128,250
5275,5238586256,879,2,111,133,244
5276,5238586256,879,3,134,111,245
5277,5238586256,879,4,133,113,246
5278,5238586256,879,5,134,122,256
5279,5238586256,879,6,124,135,259
5280,5238586512,880,1,120,133,253
5281,5238586512,880,2,119,127,246
5282,5238586512,880,3,134,111,245
5283,5238586512,880,4,130,120,250
5284,5238586512,880,5,136,117,253
5285,5238586512,880,6,119,134,253
5286,5238586640,881,1,124,134,258
5287,5238586640,881,2,119,127,246
5288,5238586640,881,3,134,111,245
5289,5238586640,881,4,125,119,244
5290,5238586640,881,5,132,116,248
5291,5238586640,881,6,124,135,259
5292,5238586768,882,1,122,139,261
5293,5238586768,882,2,119,127,246
5294,5238586768,882,3,134,111,245
5295,5238586768,882,4,125,119,244
5296,5238586768,882,5,132,116,248
5297,5238586768,882,6,126,130,256
5298,5238586896,883,1,110,132,242
5299,5238586896,883,2,122,128,250
5300,5238586896,883,3,140,118,258
5301,5238586896,883,4,125,117,242
5302,5238586896,883,5,125,131,256
5303,5238586896,883,6,136,116,252
5304,5238587024,884,1,123,135,258
5305,5238587024,884,2,122,137,259
5306,5238587024,884,3,127,110,237
5307,5238587024,884,4,141,112,253
5308,5238587024,884,5,130,118,248
5309,5238587024,884,6,115,130,245
5310,5238587280,885,1,118,128,246
5311,5238587280,885,2,122,137,259
5312,5238587280,885,3,127,110,237
5313,5238587280,885,4,141,112,253
5314,5238587280,885,5,135,125,260
5315,5238587280,885,6,115,130,245
5316,5240823888,886,1,114,137,251
5317,5240823888,886,2,115,126,241
5318,5240823888,886,3,133,122,255
5319,5240823888,886,4,141,112,253
5320,5240823888,886,5,140,112,252
5321,5240823888,886,6,115,133,248
5322,5240824016,887,1,111,141,252
5323,5240824016,887,2,115,126,241
5324,5240824016,887,3,133,122,255
5325,5240824016,887,4,141,112,253
5326,5240824016,887,5,143,108,251
5327,5240824016,887,6,115,133,248
5328,5240824144,888,1,120,132,252
5329,5240824144,888,2,129,120,249
5330,5240824144,888,3,113,126,239
5331,5240824144,888,4,125,122,247
5332,5240824144,888,5,143,113,256
5333,5240824144,888,6,128,129,257
5334,5240824272,889,1,120,132,252
5335,5240824272,889,2,129,120,249
5336,5240824272,889,3,113,126,239
5337,5240824272,889,4,129,134,263
5338,5240824272,889,5,143,113,256
5339,5240824272,889,6,124,117,241
5340,5240824400,890,1,126,133,259
5341,5240824400,890,2,135,119,254
5342,5240824400,890,3,136,108,244
5343,5240824400,890,4,128,112,240
5344,5240824400,890,5,115,126,241
5345,5240824400,890,6,118,144,262
5346,5240824528,891,1,129,131,260
5347,5240824528,891,2,122,119,241
5348,5240824528,891,3,135,106,241
5349,5240824528,891,4,138,121,259
5350,5240824528,891,5,119,119,238
5351,5240824528,891,6,115,146,261
5352,5240824656,892,1,131,128,259
5353,5240824656,892,2,122,119,241
5354,5240824656,892,3,135,106,241
5355,5240824656,892,4,131,111,242
5356,5240824656,892,5,126,129,255
5357,5240824656,892,6,113,149,262
5358,5240824784,893,1,124,120,244
5359,5240824784,893,2,135,120,255
5360,5240824784,893,3,144,107,251
5361,5240824784,893,4,121,116,237
5362,5240824784,893,5,122,137,259
5363,5240824784,893,6,112,142,254
5364,5240824912,894,1,127,126,253
5365,5240824912,894,2,135,122,257
5366,5240824912,894,3,145,115,260
5367,5240824912,894,4,136,110,246
5368,5240824912,894,5,111,133,244
5369,5240824912,894,6,104,136,240
5370,5240825040,895,1,145,111,256
5371,5240825040,895,2,126,129,255
5372,5240825040,895,3,117,131,248
5373,5240825040,895,4,122,121,243
5374,5240825040,895,5,126,122,248
5375,5240825040,895,6,122,128,250
5376,5240825168,896,1,145,111,256
5377,5240825168,896,2,122,122,244
5378,5240825168,896,3,117,131,248
5379,5240825168,896,4,122,121,243
5380,5240825168,896,5,126,122,248
5381,5240825168,896,6,126,135,261
5382,5240825296,897,1,144,102,246
5383,5240825296,897,2,121,124,245
5384,5240825296,897,3,119,141,260
5385,5240825296,897,4,127,129,256
5386,5240825296,897,5,131,123,254
5387,5240825296,897,6,116,123,239
5388,5240825424,898,1,117,125,242
5389,5240825424,898,2,139,123,262
5390,5240825424,898,3,126,120,246
5391,5240825424,898,4,136,110,246
5392,5240825424,898,5,126,128,254
5393,5240825424,898,6,114,136,250
5394,5240825680,899,1,128,113,241
5395,5240825680,899,2,126,127,253
5396,5240825680,899,3,121,125,246
5397,5240825680,899,4,151,108,259
5398,5240825680,899,5,118,126,244
5399,5240825680,899,6,114,143,257
5400,5240825808,900,1,137,104,241
5401,5240825808,900,2,129,129,258
5402,5240825808,900,3,122,133,255
5403,5240825808,900,4,113,126,239
5404,5240825808,900,5,135,128,263
5405,5240825808,900,6,122,122,244
5406,5240825936,901,1,144,115,259
5407,5240825936,901,2,135,127,262
5408,5240825936,901,3,114,136,250
5409,5240825936,901,4,122,128,250
5410,5240825936,901,5,123,118,241
5411,5240825936,901,6,120,118,238
5412,5240826064,902,1,118,120,238
5413,5240826064,902,2,123,125,248
5414,5240826064,902,3,130,121,251
5415,5240826064,902,4,129,128,257
5416,5240826064,902,5,147,110,257
5417,5240826064,902,6,111,138,249
5418,5240826320,903,1,124,129,253
5419,5240826320,903,2,129,122,251
5420,5240826320,903,3,143,111,254
5421,5240826320,903,4,125,118,243
5422,5240826320,903,5,119,134,253
5423,5240826320,903,6,118,128,246
5424,5240826448,904,1,122,131,253
5425,5240826448,904,2,131,121,252
5426,5240826448,904,3,143,111,254
5427,5240826448,904,4,121,117,238
5428,5240826448,904,5,126,137,263
5429,5240826448,904,6,115,125,240
5430,5240826576,905,1,122,131,253
5431,5240826576,905,2,127,114,241
5432,5240826576,905,3,143,111,254
5433,5240826576,905,4,121,117,238
5434,5240826576,905,5,126,137,263
5435,5240826576,905,6,119,132,251
5436,5240826704,906,1,122,137,259
5437,5240826704,906,2,124,118,242
5438,5240826704,906,3,143,111,254
5439,5240826704,906,4,130,113,243
5440,5240826704,906,5,118,127,245
5441,5240826704,906,6,121,136,257
5442,5240826960,907,1,113,126,239
5443,5240826960,907,2,124,118,242
5444,5240826960,907,3,143,111,254
5445,5240826960,907,4,139,124,263
5446,5240826960,907,5,118,127,245
5447,5240826960,907,6,121,136,257
5448,5240827088,908,1,122,137,259
5449,5240827088,908,2,129,110,239
5450,5240827088,908,3,141,109,250
5451,5240827088,908,4,133,120,253
5452,5240827088,908,5,119,134,253
5453,5240827088,908,6,114,132,246
5454,5240827216,909,1,115,126,241
5455,5240827216,909,2,125,135,260
5456,5240827216,909,3,138,104,242
5457,5240827216,909,4,135,119,254
5458,5240827216,909,5,129,129,258
5459,5240827216,909,6,116,129,245
5460,5240827344,910,1,115,126,241
5461,5240827344,910,2,121,126,247
5462,5240827344,910,3,138,104,242
5463,5240827344,910,4,135,119,254
5464,5240827344,910,5,129,129,258
5465,5240827344,910,6,120,138,258
5466,5240827472,911,1,124,137,261
5467,5240827472,911,2,114,126,240
5468,5240827472,911,3,132,114,246
5469,5240827472,911,4,132,115,247
5470,5240827472,911,5,139,114,253
5471,5240827472,911,6,117,136,253
5472,5240827600,912,1,124,137,261
5473,5240827600,912,2,114,126,240
5474,5240827600,912,3,135,123,258
5475,5240827600,912,4,132,115,247
5476,5240827600,912,5,139,114,253
5477,5240827600,912,6,114,127,241
5478,5240827856,913,1,133,129,262
5479,5240827856,913,2,147,116,263
5480,5240827856,913,3,115,130,245
5481,5240827856,913,4,134,108,242
5482,5240827856,913,5,118,123,241
5483,5240827856,913,6,111,136,247
5484,5243040016,914,1,133,129,262
5485,5243040016,914,2,137,109,246
5486,5243040016,914,3,125,137,262
5487,5243040016,914,4,134,108,242
5488,5243040016,914,5,118,123,241
5489,5243040016,914,6,111,136,247
5490,5243040272,915,1,123,117,240
5491,5243040272,915,2,146,115,261
5492,5243040272,915,3,120,120,240
5493,5243040272,915,4,129,118,247
5494,5243040272,915,5,128,135,263
5495,5243040272,915,6,112,137,249
5496,5243040400,916,1,129,129,258
5497,5243040400,916,2,135,113,248
5498,5243040400,916,3,119,125,244
5499,5243040400,916,4,130,118,248
5500,5243040400,916,5,125,119,244
5501,5243040400,916,6,120,138,258
5502,5243040528,917,1,135,119,254
5503,5243040528,917,2,137,116,253
5504,5243040528,917,3,128,113,241
5505,5243040528,917,4,117,140,257
5506,5243040528,917,5,118,119,237
5507,5243040528,917,6,123,135,258
5508,5243040656,918,1,124,116,240
5509,5243040656,918,2,139,103,242
5510,5243040656,918,3,132,130,262
5511,5243040656,918,4,121,135,256
5512,5243040656,918,5,129,122,251
5513,5243040656,918,6,113,136,249
5514,5243040784,919,1,142,117,259
5515,5243040784,919,2,126,117,243
5516,5243040784,919,3,125,130,255
5517,5243040784,919,4,136,123,259
5518,5243040784,919,5,111,133,244
5519,5243040784,919,6,118,122,240
5520,5243040912,920,1,126,122,248
5521,5243040912,920,2,125,122,247
5522,5243040912,920,3,115,142,257
5523,5243040912,920,4,137,110,247
5524,5243040912,920,5,122,121,243
5525,5243040912,920,6,133,125,258
5526,5243041040,921,1,122,129,251
5527,5243041040,921,2,128,116,244
5528,5243041040,921,3,121,127,248
5529,5243041040,921,4,120,138,258
5530,5243041040,921,5,128,117,245
5531,5243041040,921,6,139,115,254
5532,5243041168,922,1,124,129,253
5533,5243041168,922,2,125,118,243
5534,5243041168,922,3,121,127,248
5535,5243041168,922,4,120,138,258
5536,5243041168,922,5,128,117,245
5537,5243041168,922,6,140,113,253
5538,5243041296,923,1,121,129,250
5539,5243041296,923,2,130,125,255
5540,5243041296,923,3,134,128,262
5541,5243041296,923,4,117,138,255
5542,5243041296,923,5,121,118,239
5543,5243041296,923,6,135,104,239
5544,5243041424,924,1,126,120,246
5545,5243041424,924,2,117,127,244
5546,5243041424,924,3,119,125,244
5547,5243041424,924,4,113,137,250
5548,5243041424,924,5,138,122,260
5549,5243041424,924,6,145,111,256
5550,5243041552,925,1,145,118,263
5551,5243041552,925,2,123,139,262
5552,5243041552,925,3,115,133,248
5553,5243041552,925,4,112,127,239
5554,5243041552,925,5,127,116,243
5555,5243041552,925,6,136,109,245
5556,5243041680,926,1,121,118,239
5557,5243041680,926,2,137,123,260
5558,5243041680,926,3,127,134,261
5559,5243041680,926,4,116,129,245
5560,5243041680,926,5,135,104,239
5561,5243041680,926,6,122,134,256
5562,5243041808,927,1,121,118,239
5563,5243041808,927,2,137,123,260
5564,5243041808,927,3,127,134,261
5565,5243041808,927,4,121,130,251
5566,5243041808,927,5,135,104,239
5567,5243041808,927,6,117,133,250
5568,5243041936,928,1,128,115,243
5569,5243041936,928,2,126,123,249
5570,5243041936,928,3,129,123,252
5571,5243041936,928,4,133,115,248
5572,5243041936,928,5,125,126,251
5573,5243041936,928,6,117,140,257
5574,5243042064,929,1,123,118,241
5575,5243042064,929,2,137,110,247
5576,5243042064,929,3,114,134,248
5577,5243042064,929,4,128,120,248
5578,5243042064,929,5,129,132,261
5579,5243042064,929,6,127,128,255
5580,5243042192,930,1,141,120,261
5581,5243042192,930,2,133,117,250
5582,5243042192,930,3,112,131,243
5583,5243042192,930,4,118,128,246
5584,5243042192,930,5,125,118,243
5585,5243042192,930,6,129,128,257
5586,5243042320,931,1,141,120,261
5587,5243042320,931,2,130,108,238
5588,5243042320,931,3,112,131,243
5589,5243042320,931,4,121,137,258
5590,5243042320,931,5,125,118,243
5591,5243042320,931,6,129,128,257
5592,5243042448,932,1,120,129,249
5593,5243042448,932,2,114,140,254
5594,5243042448,932,3,127,127,254
5595,5243042448,932,4,126,113,239
5596,5243042448,932,5,133,109,242
5597,5243042448,932,6,138,124,262
5598,5243042704,933,1,113,126,239
5599,5243042704,933,2,114,140,254
5600,5243042704,933,3,127,127,254
5601,5243042704,933,4,126,113,239
5602,5243042704,933,5,140,112,252
5603,5243042704,933,6,138,124,262
5604,5243042832,934,1,113,126,239
5605,5243042832,934,2,114,140,254
5606,5243042832,934,3,120,118,238
5607,5243042832,934,4,133,122,255
5608,5243042832,934,5,140,112,252
5609,5243042832,934,6,138,124,262
5610,5243042960,935,1,127,110,237
5611,5243042960,935,2,118,138,256
5612,5243042960,935,3,131,112,243
5613,5243042960,935,4,130,130,260
5614,5243042960,935,5,123,139,262
5615,5243042960,935,6,129,113,242
5616,5243043088,936,1,134,115,249
5617,5243043088,936,2,136,127,263
5618,5243043088,936,3,117,131,248
5619,5243043088,936,4,132,121,253
5620,5243043088,936,5,119,123,242
5621,5243043088,936,6,120,125,245
5622,5243043216,937,1,128,116,244
5623,5243043216,937,2,132,122,254
5624,5243043216,937,3,116,139,255
5625,5243043216,937,4,121,116,237
5626,5243043216,937,5,126,127,253
5627,5243043216,937,6,135,122,257
5628,5243043344,938,1,142,121,263
5629,5243043344,938,2,123,117,240
5630,5243043344,938,3,120,123,243
5631,5243043344,938,4,107,130,237
5632,5243043344,938,5,119,136,255
5633,5243043344,938,6,147,115,262
5634,5243043472,939,1,130,107,237
5635,5243043472,939,2,143,120,263
5636,5243043472,939,3,122,138,260
5637,5243043472,939,4,127,125,252
5638,5243043472,939,5,116,127,243
5639,5243043472,939,6,120,125,245
5640,5243043600,940,1,141,119,260
5641,5243043600,940,2,119,129,248
5642,5243043600,940,3,122,118,240
5643,5243043600,940,4,117,140,257
5644,5243043600,940,5,122,128,250
5645,5243043600,940,6,137,108,245
5646,5243043728,941,1,122,137,259
5647,5243043728,941,2,125,120,245
5648,5243043728,941,3,137,115,252
5649,5243043728,941,4,108,129,237
5650,5243043728,941,5,137,123,260
5651,5243043728,941,6,129,118,247
5652,5245272144,942,1,138,109,247
5653,5245272144,942,2,119,129,248
5654,5245272144,942,3,129,118,247
5655,5245272144,942,4,130,122,252
5656,5245272144,942,5,117,127,244
5657,5245272144,942,6,125,137,262
5658,5245272272,943,1,138,109,247
5659,5245272272,943,2,119,129,248
5660,5245272272,943,3,135,124,259
5661,5245272272,943,4,130,122,252
5662,5245272272,943,5,117,127,244
5663,5245272272,943,6,119,131,250
5664,5245272400,944,1,141,107,248
5665,5245272400,944,2,119,129,248
5666,5245272400,944,3,137,124,261
5667,5245272400,944,4,127,124,251
5668,5245272400,944,5,117,127,244
5669,5245272400,944,6,117,131,248
5670,5245272528,945,1,141,107,248
5671,5245272528,945,2,118,131,249
5672,5245272528,945,3,131,118,249
5673,5245272528,945,4,127,124,251
5674,5245272528,945,5,117,127,244
5675,5245272528,945,6,124,135,259
5676,5245272656,946,1,140,115,255
5677,5245272656,946,2,122,127,249
5678,5245272656,946,3,117,129,246
5679,5245272656,946,4,114,128,242
5680,5245272656,946,5,138,122,260
5681,5245272656,946,6,127,121,248
5682,5245272784,947,1,142,112,254
5683,5245272784,947,2,119,119,238
5684,5245272784,947,3,113,128,241
5685,5245272784,947,4,131,130,261
5686,5245272784,947,5,119,126,245
5687,5245272784,947,6,134,127,261
5688,5245272912,948,1,137,116,253
5689,5245272912,948,2,127,129,256
5690,5245272912,948,3,114,132,246
5691,5245272912,948,4,129,126,255
5692,5245272912,948,5,119,126,245
5693,5245272912,948,6,132,113,245
5694,5245273040,949,1,127,123,250
5695,5245273040,949,2,115,135,250
5696,5245273040,949,3,118,129,247
5697,5245273040,949,4,127,117,244
5698,5245273040,949,5,126,133,259
5699,5245273040,949,6,145,105,250
5700,5245273168,950,1,134,111,245
5701,5245273168,950,2,121,133,254
5702,5245273168,950,3,111,129,240
5703,5245273168,950,4,112,132,244
5704,5245273168,950,5,141,114,255
5705,5245273168,950,6,139,123,262
5706,5245273296,951,1,139,120,259
5707,5245273296,951,2,126,131,257
5708,5245273296,951,3,111,129,240
5709,5245273296,951,4,119,136,255
5710,5245273296,951,5,143,107,250
5711,5245273296,951,6,120,119,239
5712,5245273552,952,1,127,116,243
5713,5245273552,952,2,137,122,259
5714,5245273552,952,3,115,133,248
5715,5245273552,952,4,122,119,241
5716,5245273552,952,5,134,122,256
5717,5245273552,952,6,123,130,253
5718,5245273680,953,1,133,113,246
5719,5245273680,953,2,110,128,238
5720,5245273680,953,3,142,120,262
5721,5245273680,953,4,134,124,258
5722,5245273680,953,5,122,128,250
5723,5245273680,953,6,117,129,246
5724,5245273808,954,1,133,113,246
5725,5245273808,954,2,120,139,259
5726,5245273808,954,3,128,113,241
5727,5245273808,954,4,134,124,258
5728,5245273808,954,5,122,128,250
5729,5245273808,954,6,121,125,246
5730,5245273936,955,1,140,113,253
5731,5245273936,955,2,110,128,238
5732,5245273936,955,3,132,130,262
5733,5245273936,955,4,134,124,258
5734,5245273936,955,5,122,128,250
5735,5245273936,955,6,120,119,239
5736,5245274064,956,1,140,113,253
5737,5245274064,956,2,110,128,238
5738,5245274064,956,3,125,122,247
5739,5245274064,956,4,134,126,260
5740,5245274064,956,5,122,126,248
5741,5245274064,956,6,127,127,254
5742,5245274192,957,1,143,114,257
5743,5245274192,957,2,121,124,245
5744,5245274192,957,3,135,122,257
5745,5245274192,957,4,132,121,253
5746,5245274192,957,5,122,127,249
5747,5245274192,957,6,105,134,239
5748,5245274448,958,1,143,114,257
5749,5245274448,958,2,121,124,245
5750,5245274448,958,3,130,115,245
5751,5245274448,958,4,132,121,253
5752,5245274448,958,5,122,127,249
5753,5245274448,958,6,110,141,251
5754,5245274704,959,1,134,128,262
5755,5245274704,959,2,121,125,246
5756,5245274704,959,3,118,128,246
5757,5245274704,959,4,142,109,251
5758,5245274704,959,5,122,128,250
5759,5245274704,959,6,121,124,245
5760,5245274832,960,1,129,121,250
5761,5245274832,960,2,138,123,261
5762,5245274832,960,3,112,131,243
5763,5245274832,960,4,130,110,240
5764,5245274832,960,5,123,128,251
5765,5245274832,960,6,126,129,255
5766,5245274960,961,1,116,131,247
5767,5245274960,961,2,133,116,249
5768,5245274960,961,3,144,115,259
5769,5245274960,961,4,126,121,247
5770,5245274960,961,5,127,134,261
5771,5245274960,961,6,112,125,237
5772,5245275088,962,1,122,120,242
5773,5245275088,962,2,116,125,241
5774,5245275088,962,3,141,122,263
5775,5245275088,962,4,133,115,248
5776,5245275088,962,5,112,132,244
5777,5245275088,962,6,134,128,262
5778,5245275216,963,1,135,124,259
5779,5245275216,963,2,122,134,256
5780,5245275216,963,3,131,108,239
5781,5245275216,963,4,126,124,250
5782,5245275216,963,5,118,134,252
5783,5245275216,963,6,126,118,244
5784,5245275344,964,1,137,125,262
5785,5245275344,964,2,109,130,239
5786,5245275344,964,3,131,113,244
5787,5245275344,964,4,128,118,246
5788,5245275344,964,5,119,127,246
5789,5245275344,964,6,134,129,263
5790,5245275472,965,1,137,125,262
5791,5245275472,965,2,116,142,258
5792,5245275472,965,3,131,113,244
5793,5245275472,965,4,131,117,248
5794,5245275472,965,5,119,127,246
5795,5245275472,965,6,124,118,242
5796,5245275600,966,1,131,128,259
5797,5245275600,966,2,123,115,238
5798,5245275600,966,3,144,112,256
5799,5245275600,966,4,118,122,240
5800,5245275600,966,5,112,132,244
5801,5245275600,966,6,130,133,263
5802,5245275856,967,1,133,128,261
5803,5245275856,967,2,123,115,238
5804,5245275856,967,3,144,112,256
5805,5245275856,967,4,118,122,240
5806,5245275856,967,5,112,132,244
5807,5245275856,967,6,128,133,261
5808,5247484048,968,1,131,128,259
5809,5247484048,968,2,127,127,254
5810,5247484048,968,3,144,112,256
5811,5247484048,968,4,126,121,247
5812,5247484048,968,5,112,132,244
5813,5247484048,968,6,118,122,240
5814,5247484176,969,1,131,128,259
5815,5247484176,969,2,123,115,238
5816,5247484176,969,3,144,112,256
5817,5247484176,969,4,130,133,263
5818,5247484176,969,5,112,132,244
5819,5247484176,969,6,118,122,240
5820,5247484304,970,1,134,119,253
5821,5247484304,970,2,126,118,244
5822,5247484304,970,3,143,102,245
5823,5247484304,970,4,109,138,247
5824,5247484304,970,5,131,132,263
5825,5247484304,970,6,115,133,248
5826,5247484432,971,1,133,127,260
5827,5247484432,971,2,126,134,260
5828,5247484432,971,3,116,129,245
5829,5247484432,971,4,139,113,252
5830,5247484432,971,5,133,107,240
5831,5247484432,971,6,111,132,243
5832,5247484560,972,1,119,126,245
5833,5247484560,972,2,128,126,254
5834,5247484560,972,3,118,123,241
5835,5247484560,972,4,123,135,258
5836,5247484560,972,5,150,113,263
5837,5247484560,972,6,120,119,239
5838,5247484688,973,1,118,124,242
5839,5247484688,973,2,122,115,237
5840,5247484688,973,3,132,130,262
5841,5247484688,973,4,117,143,260
5842,5247484688,973,5,144,105,249
5843,5247484688,973,6,125,125,250
5844,5247484816,974,1,122,141,263
5845,5247484816,974,2,133,109,242
5846,5247484816,974,3,113,126,239
5847,5247484816,974,4,125,125,250
5848,5247484816,974,5,141,121,262
5849,5247484816,974,6,124,120,244
5850,5247484944,975,1,131,130,261
5851,5247484944,975,2,136,103,239
5852,5247484944,975,3,120,139,259
5853,5247484944,975,4,132,114,246
5854,5247484944,975,5,122,127,249
5855,5247484944,975,6,117,129,246
5856,5247485072,976,1,124,132,256
5857,5247485072,976,2,144,114,258
5858,5247485072,976,3,132,119,251
5859,5247485072,976,4,117,125,242
5860,5247485072,976,5,127,120,247
5861,5247485072,976,6,114,132,246
5862,5247485200,977,1,126,114,240
5863,5247485200,977,2,136,123,259
5864,5247485200,977,3,117,131,248
5865,5247485200,977,4,148,113,261
5866,5247485200,977,5,117,127,244
5867,5247485200,977,6,114,134,248
5868,5247485328,978,1,130,117,247
5869,5247485328,978,2,126,121,247
5870,5247485328,978,3,122,132,254
5871,5247485328,978,4,144,112,256
5872,5247485328,978,5,122,126,248
5873,5247485328,978,6,114,134,248
5874,5247485456,979,1,136,108,244
5875,5247485456,979,2,119,130,249
5876,5247485456,979,3,121,131,252
5877,5247485456,979,4,144,108,252
5878,5247485456,979,5,117,130,247
5879,5247485456,979,6,121,135,256
5880,5247485584,980,1,143,119,262
5881,5247485584,980,2,110,141,251
5882,5247485584,980,3,121,131,252
5883,5247485584,980,4,138,104,242
5884,5247485584,980,5,119,127,246
5885,5247485584,980,6,127,120,247
5886,5247485712,981,1,130,130,260
5887,5247485712,981,2,125,125,250
5888,5247485712,981,3,135,125,260
5889,5247485712,981,4,120,117,237
5890,5247485712,981,5,121,125,246
5891,5247485712,981,6,127,120,247
5892,5247485840,982,1,125,118,243
5893,5247485840,982,2,135,112,247
5894,5247485840,982,3,128,121,249
5895,5247485840,982,4,110,132,242
5896,5247485840,982,5,129,132,261
5897,5247485840,982,6,131,127,258
5898,5247485968,983,1,132,123,255
5899,5247485968,983,2,131,107,238
5900,5247485968,983,3,135,121,256
5901,5247485968,983,4,112,130,242
5902,5247485968,983,5,126,133,259
5903,5247485968,983,6,122,128,250
5904,5247486096,984,1,116,122,238
5905,5247486096,984,2,122,130,252
5906,5247486096,984,3,131,119,250
5907,5247486096,984,4,134,119,253
5908,5247486096,984,5,126,134,260
5909,5247486096,984,6,129,118,247
5910,5247486224,985,1,118,122,240
5911,5247486224,985,2,138,122,260
5912,5247486224,985,3,133,113,246
5913,5247486224,985,4,116,142,258
5914,5247486224,985,5,133,121,254
5915,5247486224,985,6,120,122,242
5916,5247486352,986,1,123,128,251
5917,5247486352,986,2,130,124,254
5918,5247486352,986,3,131,111,242
5919,5247486352,986,4,118,133,251
5920,5247486352,986,5,133,124,257
5921,5247486352,986,6,123,122,245
5922,5247486480,987,1,132,128,260
5923,5247486480,987,2,129,119,248
5924,5247486480,987,3,150,112,262
5925,5247486480,987,4,112,130,242
5926,5247486480,987,5,115,123,238
5927,5247486480,987,6,120,130,250
5928,5247486608,988,1,132,122,254
5929,5247486608,988,2,147,110,257
5930,5247486608,988,3,117,140,257
5931,5247486608,988,4,119,122,241
5932,5247486608,988,5,123,116,239
5933,5247486608,988,6,120,132,252
5934,5247486736,989,1,140,121,261
5935,5247486736,989,2,146,104,250
5936,5247486736,989,3,121,133,254
5937,5247486736,989,4,114,131,245
5938,5247486736,989,5,116,130,246
5939,5247486736,989,6,121,123,244
5940,5247486864,990,1,125,127,252
5941,5247486864,990,2,144,111,255
5942,5247486864,990,3,125,136,261
5943,5247486864,990,4,109,129,238
5944,5247486864,990,5,121,117,238
5945,5247486864,990,6,134,122,256
5946,5247486992,991,1,125,127,252
5947,5247486992,991,2,134,104,238
5948,5247486992,991,3,125,136,261
5949,5247486992,991,4,119,136,255
5950,5247486992,991,5,121,117,238
5951,5247486992,991,6,134,122,256
5952,5247487120,992,1,124,131,255
5953,5247487120,992,2,147,110,257
5954,5247487120,992,3,132,123,255
5955,5247487120,992,4,109,131,240
5956,5247487120,992,5,132,121,253
5957,5247487120,992,6,114,126,240
5958,5247487248,993,1,133,128,261
5959,5247487248,993,2,128,116,244
5960,5247487248,993,3,120,133,253
5961,5247487248,993,4,122,136,258
5962,5247487248,993,5,121,117,238
5963,5247487248,993,6,134,112,246
5964,5247487376,994,1,122,117,239
5965,5247487376,994,2,128,116,244
5966,5247487376,994,3,120,133,253
5967,5247487376,994,4,122,136,258
5968,5247487376,994,5,132,128,260
5969,5247487376,994,6,134,112,246
5970,5247487504,995,1,125,117,242
5971,5247487504,995,2,130,110,240
5972,5247487504,995,3,118,139,257
5973,5247487504,995,4,126,133,259
5974,5247487504,995,5,129,128,257
5975,5247487504,995,6,130,115,245
5976,5247487632,996,1,124,126,250
5977,5247487632,996,2,134,104,238
5978,5247487632,996,3,118,126,244
5979,5247487632,996,4,119,143,262
5980,5247487632,996,5,129,128,257
5981,5247487632,996,6,134,115,249
5982,5247487760,997,1,124,126,250
5983,5247487760,997,2,134,104,238
5984,5247487760,997,3,125,138,263
5985,5247487760,997,4,116,132,248
5986,5247487760,997,5,129,128,257
5987,5247487760,997,6,130,114,244
5988,5247487888,998,1,121,122,243
5989,5247487888,998,2,144,116,260
5990,5247487888,998,3,133,114,247
5991,5247487888,998,4,110,134,244
5992,5247487888,998,5,122,126,248
5993,5247487888,998,6,128,130,258
5994,5249720400,999,1,130,124,254
5995,5249720400,999,2,126,116,242
5996,5249720400,999,3,144,115,259
5997,5249720400,999,4,116,129,245
5998,5249720400,999,5,126,128,254
5999,5249720400,999,6,116,130,246
6000,5249720528,1000,1,130,124,254
6001,5249720528,1000,2,131,117,248
6002,5249720528,1000,3,139,114,253
6003,5249720528,1000,4,116,129,245
6004,5249720528,1000,5,126,128,254
6005,5249720528,1000,6,116,130,246
6006,5249720656,1001,1,133,129,262
6007,5249720656,1001,2,130,116,246
6008,5249720656,1001,3,140,104,244
6009,5249720656,1001,4,114,136,250
6010,5249720656,1001,5,122,128,250
6011,5249720656,1001,6,119,129,248
6012,5249720784,1002,1,131,125,256
6013,5249720784,1002,2,131,110,241
6014,5249720784,1002,3,129,114,243
6015,5249720784,1002,4,121,137,258
6016,5249720784,1002,5,113,126,239
6017,5249720784,1002,6,133,130,263
6018,5249720912,1003,1,124,129,253
6019,5249720912,1003,2,128,118,246
6020,5249720912,1003,3,122,129,251
6021,5249720912,1003,4,128,118,246
6022,5249720912,1003,5,125,118,243
6023,5249720912,1003,6,131,130,261
6024,5249721040,1004,1,113,126,239
6025,5249721040,1004,2,112,131,243
6026,5249721040,1004,3,139,119,258
6027,5249721040,1004,4,137,110,247
6028,5249721040,1004,5,129,123,252
6029,5249721040,1004,6,128,133,261
6030,5249721168,1005,1,113,126,239
6031,5249721168,1005,2,116,141,257
6032,5249721168,1005,3,139,119,258
6033,5249721168,1005,4,137,110,247
6034,5249721168,1005,5,129,123,252
6035,5249721168,1005,6,124,123,247
6036,5249721296,1006,1,126,124,250
6037,5249721296,1006,2,122,134,256
6038,5249721296,1006,3,118,126,244
6039,5249721296,1006,4,143,106,249
6040,5249721296,1006,5,121,123,244
6041,5249721296,1006,6,128,129,257
6042,5249721424,1007,1,126,124,250
6043,5249721424,1007,2,122,134,256
6044,5249721424,1007,3,125,138,263
6045,5249721424,1007,4,143,106,249
6046,5249721424,1007,5,121,123,244
6047,5249721424,1007,6,121,117,238
6048,5249721552,1008,1,147,106,253
6049,5249721552,1008,2,129,131,260
6050,5249721552,1008,3,124,117,241
6051,5249721552,1008,4,127,121,248
6052,5249721552,1008,5,121,135,256
6053,5249721552,1008,6,110,132,242
6054,5249721680,1009,1,140,119,259
6055,5249721680,1009,2,130,115,245
6056,5249721680,1009,3,117,138,255
6057,5249721680,1009,4,118,130,248
6058,5249721680,1009,5,116,122,238
6059,5249721680,1009,6,137,118,255
6060,5249721808,1010,1,142,117,259
6061,5249721808,1010,2,120,123,243
6062,5249721808,1010,3,116,125,241
6063,5249721808,1010,4,128,117,245
6064,5249721808,1010,5,121,139,260
6065,5249721808,1010,6,131,121,252
6066,5249722064,1011,1,138,114,252
6067,5249722064,1011,2,120,132,252
6068,5249722064,1011,3,116,125,241
6069,5249722064,1011,4,133,117,250
6070,5249722064,1011,5,125,136,261
6071,5249722064,1011,6,126,118,244
6072,5249722192,1012,1,125,116,241
6073,5249722192,1012,2,124,139,263
6074,5249722192,1012,3,120,139,259
6075,5249722192,1012,4,131,122,253
6076,5249722192,1012,5,121,126,247
6077,5249722192,1012,6,137,100,237
6078,5249722320,1013,1,132,107,239
6079,5249722320,1013,2,122,133,255
6080,5249722320,1013,3,110,128,238
6081,5249722320,1013,4,133,125,258
6082,5249722320,1013,5,121,139,260
6083,5249722320,1013,6,140,110,250
6084,5249722448,1014,1,125,114,239
6085,5249722448,1014,2,121,136,257
6086,5249722448,1014,3,117,138,255
6087,5249722448,1014,4,129,120,249
6088,5249722448,1014,5,129,134,263
6089,5249722448,1014,6,137,100,237
6090,5249722576,1015,1,127,110,237
6091,5249722576,1015,2,110,127,237
6092,5249722576,1015,3,121,135,256
6093,5249722576,1015,4,134,122,256
6094,5249722576,1015,5,122,137,259
6095,5249722576,1015,6,144,111,255
6096,5249722704,1016,1,133,111,244
6097,5249722704,1016,2,116,137,253
6098,5249722704,1016,3,117,124,241
6099,5249722704,1016,4,124,128,252
6100,5249722704,1016,5,123,139,262
6101,5249722704,1016,6,145,103,248
6102,5249722832,1017,1,127,115,242
6103,5249722832,1017,2,111,141,252
6104,5249722832,1017,3,136,105,241
6105,5249722832,1017,4,133,119,252
6106,5249722832,1017,5,122,137,259
6107,5249722832,1017,6,129,125,254
6108,5249722960,1018,1,122,130,252
6109,5249722960,1018,2,144,113,257
6110,5249722960,1018,3,113,126,239
6111,5249722960,1018,4,120,131,251
6112,5249722960,1018,5,127,114,241
6113,5249722960,1018,6,132,128,260
6114,5249723088,1019,1,142,114,256
6115,5249723088,1019,2,127,131,258
6116,5249723088,1019,3,113,126,239
6117,5249723088,1019,4,126,131,257
6118,5249723088,1019,5,130,108,238
6119,5249723088,1019,6,120,132,252
6120,5249723216,1020,1,135,126,261
6121,5249723216,1020,2,119,124,243
6122,5249723216,1020,3,136,112,248
6123,5249723216,1020,4,122,115,237
6124,5249723216,1020,5,122,128,250
6125,5249723216,1020,6,124,137,261
6126,5249723344,1021,1,132,113,245
6127,5249723344,1021,2,125,127,252
6128,5249723344,1021,3,128,117,245
6129,5249723344,1021,4,132,118,250
6130,5249723344,1021,5,119,126,245
6131,5249723344,1021,6,122,141,263
6132,5249723472,1022,1,121,140,261
6133,5249723472,1022,2,123,127,250
6134,5249723472,1022,3,139,115,254
6135,5249723472,1022,4,131,117,248
6136,5249723472,1022,5,117,127,244
6137,5249723472,1022,6,127,116,243
6138,5249723600,1023,1,122,130,252
6139,5249723600,1023,2,126,121,247
6140,5249723600,1023,3,130,122,252
6141,5249723600,1023,4,117,120,237
6142,5249723600,1023,5,137,115,252
6143,5249723600,1023,6,126,134,260
6144,5249723728,1024,1,122,130,252
6145,5249723728,1024,2,124,120,244
6146,5249723728,1024,3,130,122,252
6147,5249723728,1024,4,119,121,240
6148,5249723728,1024,5,137,115,252
6149,5249723728,1024,6,126,134,260
6150,5249723856,1025,1,121,137,258
6151,5249723856,1025,2,138,119,257
6152,5249723856,1025,3,116,124,240
6153,5249723856,1025,4,117,121,238
6154,5249723856,1025,5,130,118,248
6155,5249723856,1025,6,136,123,259
6156,5249723984,1026,1,118,137,255
6157,5249723984,1026,2,138,112,250
6158,5249723984,1026,3,116,134,250
6159,5249723984,1026,4,122,129,251
6160,5249723984,1026,5,136,112,248
6161,5249723984,1026,6,128,118,246
6162,5249724112,1027,1,115,128,243
6163,5249724112,1027,2,138,112,250
6164,5249724112,1027,3,116,134,250
6165,5249724112,1027,4,122,129,251
6166,5249724112,1027,5,136,112,248
6167,5249724112,1027,6,131,127,258
6168,5249724240,1028,1,115,128,243
6169,5249724240,1028,2,142,121,263
6170,5249724240,1028,3,116,134,250
6171,5249724240,1028,4,118,120,238
6172,5249724240,1028,5,136,112,248
6173,5249724240,1028,6,131,127,258
6174,5251940496,1029,1,114,132,246
6175,5251940496,1029,2,126,121,247
6176,5251940496,1029,3,119,126,245
6177,5251940496,1029,4,127,111,238
6178,5251940496,1029,5,146,115,261
6179,5251940496,1029,6,126,137,263
6180,5251940624,1030,1,120,134,254
6181,5251940624,1030,2,126,121,247
6182,5251940624,1030,3,119,126,245
6183,5251940624,1030,4,127,111,238
6184,5251940624,1030,5,146,115,261
6185,5251940624,1030,6,120,135,255
6186,5251940752,1031,1,114,137,251
6187,5251940752,1031,2,128,135,263
6188,5251940752,1031,3,123,117,240
6189,5251940752,1031,4,122,126,248
6190,5251940752,1031,5,144,109,253
6191,5251940752,1031,6,127,118,245
6192,5251940880,1032,1,114,137,251
6193,5251940880,1032,2,118,123,241
6194,5251940880,1032,3,133,129,262
6195,5251940880,1032,4,122,126,248
6196,5251940880,1032,5,144,109,253
6197,5251940880,1032,6,127,118,245
6198,5251941008,1033,1,114,137,251
6199,5251941008,1033,2,127,132,259
6200,5251941008,1033,3,123,117,240
6201,5251941008,1033,4,122,126,248
6202,5251941008,1033,5,145,112,257
6203,5251941008,1033,6,127,118,245
6204,5251941136,1034,1,110,139,249
6205,5251941136,1034,2,114,128,242
6206,5251941136,1034,3,136,121,257
6207,5251941136,1034,4,126,124,250
6208,5251941136,1034,5,145,110,255
6209,5251941136,1034,6,127,120,247
6210,5251941264,1035,1,129,131,260
6211,5251941264,1035,2,130,112,242
6212,5251941264,1035,3,124,116,240
6213,5251941264,1035,4,127,127,254
6214,5251941264,1035,5,119,128,247
6215,5251941264,1035,6,129,128,257
6216,5251941392,1036,1,114,134,248
6217,5251941392,1036,2,129,128,257
6218,5251941392,1036,3,136,113,249
6219,5251941392,1036,4,127,124,251
6220,5251941392,1036,5,129,108,237
6221,5251941392,1036,6,123,135,258
6222,5251941520,1037,1,119,137,256
6223,5251941520,1037,2,119,126,245
6224,5251941520,1037,3,131,110,241
6225,5251941520,1037,4,135,122,257
6226,5251941520,1037,5,120,123,243
6227,5251941520,1037,6,134,124,258
6228,5251941776,1038,1,132,116,248
6229,5251941776,1038,2,113,126,239
6230,5251941776,1038,3,141,117,258
6231,5251941776,1038,4,131,116,247
6232,5251941776,1038,5,119,134,253
6233,5251941776,1038,6,122,133,255
6234,5251941904,1039,1,126,113,239
6235,5251941904,1039,2,133,129,262
6236,5251941904,1039,3,136,113,249
6237,5251941904,1039,4,126,124,250
6238,5251941904,1039,5,118,129,247
6239,5251941904,1039,6,119,134,253
6240,5251942032,1040,1,132,119,251
6241,5251942032,1040,2,133,129,262
6242,5251942032,1040,3,136,113,249
6243,5251942032,1040,4,126,124,250
6244,5251942032,1040,5,118,129,247
6245,5251942032,1040,6,113,128,241
6246,5251942160,1041,1,127,136,263
6247,5251942160,1041,2,126,133,259
6248,5251942160,1041,3,109,130,239
6249,5251942160,1041,4,131,107,238
6250,5251942160,1041,5,142,118,260
6251,5251942160,1041,6,123,118,241
6252,5251942416,1042,1,135,125,260
6253,5251942416,1042,2,136,112,248
6254,5251942416,1042,3,129,125,254
6255,5251942416,1042,4,122,125,247
6256,5251942416,1042,5,121,125,246
6257,5251942416,1042,6,115,130,245
6258,5251942544,1043,1,138,124,262
6259,5251942544,1043,2,140,104,244
6260,5251942544,1043,3,125,115,240
6261,5251942544,1043,4,118,126,244
6262,5251942544,1043,5,117,140,257
6263,5251942544,1043,6,120,133,253
6264,5251942672,1044,1,128,117,245
6265,5251942672,1044,2,140,104,244
6266,5251942672,1044,3,133,129,262
6267,5251942672,1044,4,118,126,244
6268,5251942672,1044,5,118,139,257
6269,5251942672,1044,6,121,127,248
6270,5251942800,1045,1,132,121,253
6271,5251942800,1045,2,143,111,254
6272,5251942800,1045,3,129,125,254
6273,5251942800,1045,4,116,127,243
6274,5251942800,1045,5,117,138,255
6275,5251942800,1045,6,121,120,241
6276,5251942928,1046,1,133,110,243
6277,5251942928,1046,2,134,115,249
6278,5251942928,1046,3,126,114,240
6279,5251942928,1046,4,117,127,244
6280,5251942928,1046,5,126,136,262
6281,5251942928,1046,6,122,140,262
6282,5251943056,1047,1,123,129,252
6283,5251943056,1047,2,137,111,248
6284,5251943056,1047,3,136,121,257
6285,5251943056,1047,4,113,126,239
6286,5251943056,1047,5,130,112,242
6287,5251943056,1047,6,119,143,262
6288,5251943184,1048,1,130,132,262
6289,5251943184,1048,2,121,129,250
6290,5251943184,1048,3,139,109,248
6291,5251943184,1048,4,124,114,238
6292,5251943184,1048,5,117,131,248
6293,5251943184,1048,6,127,127,254
6294,5251943312,1049,1,130,132,262
6295,5251943312,1049,2,121,129,250
6296,5251943312,1049,3,139,109,248
6297,5251943312,1049,4,124,114,238
6298,5251943312,1049,5,125,138,263
6299,5251943312,1049,6,119,120,239
6300,5251943440,1050,1,130,132,262
6301,5251943440,1050,2,121,129,250
6302,5251943440,1050,3,139,109,248
6303,5251943440,1050,4,134,127,261
6304,5251943440,1050,5,115,125,240
6305,5251943440,1050,6,119,120,239
6306,5251943568,1051,1,128,121,249
6307,5251943568,1051,2,128,135,263
6308,5251943568,1051,3,143,111,254
6309,5251943568,1051,4,123,119,242
6310,5251943568,1051,5,115,130,245
6311,5251943568,1051,6,121,126,247
6312,5251943696,1052,1,117,133,250
6313,5251943696,1052,2,137,122,259
6314,5251943696,1052,3,127,114,241
6315,5251943696,1052,4,132,128,260
6316,5251943696,1052,5,129,118,247
6317,5251943696,1052,6,116,127,243
6318,5251943824,1053,1,128,133,261
6319,5251943824,1053,2,135,127,262
6320,5251943824,1053,3,136,120,256
6321,5251943824,1053,4,113,126,239
6322,5251943824,1053,5,127,112,239
6323,5251943824,1053,6,119,124,243
6324,5251943952,1054,1,119,141,260
6325,5251943952,1054,2,127,129,256
6326,5251943952,1054,3,137,109,246
6327,5251943952,1054,4,123,119,242
6328,5251943952,1054,5,140,107,247
6329,5251943952,1054,6,112,137,249
6330,5251944080,1055,1,131,128,259
6331,5251944080,1055,2,141,109,250
6332,5251944080,1055,3,134,116,250
6333,5251944080,1055,4,113,126,239
6334,5251944080,1055,5,127,132,259
6335,5251944080,1055,6,112,131,243
6336,5251944208,1056,1,124,134,258
6337,5251944208,1056,2,135,109,244
6338,5251944208,1056,3,138,101,239
6339,5251944208,1056,4,119,126,245
6340,5251944208,1056,5,131,131,262
6341,5251944208,1056,6,111,141,252
6342,5251944336,1057,1,136,105,241
6343,5251944336,1057,2,117,138,255
6344,5251944336,1057,3,118,130,248
6345,5251944336,1057,4,113,126,239
6346,5251944336,1057,5,136,121,257
6347,5251944336,1057,6,138,122,260
6348,5254172752,1058,1,136,107,243
6349,5254172752,1058,2,116,130,246
6350,5254172752,1058,3,138,119,257
6351,5254172752,1058,4,127,136,263
6352,5254172752,1058,5,121,118,239
6353,5254172752,1058,6,120,132,252
6354,5254173008,1059,1,134,117,251
6355,5254173008,1059,2,117,121,238
6356,5254173008,1059,3,126,111,237
6357,5254173008,1059,4,130,122,252
6358,5254173008,1059,5,132,128,260
6359,5254173008,1059,6,119,143,262
6360,5254173264,1060,1,115,133,248
6361,5254173264,1060,2,136,118,254
6362,5254173264,1060,3,128,116,244
6363,5254173264,1060,4,130,118,248
6364,5254173264,1060,5,132,128,260
6365,5254173264,1060,6,117,129,246
6366,5254173392,1061,1,118,131,249
6367,5254173392,1061,2,133,127,260
6368,5254173392,1061,3,140,119,259
6369,5254173392,1061,4,116,122,238
6370,5254173392,1061,5,119,118,237
6371,5254173392,1061,6,132,125,257
6372,5254173520,1062,1,135,113,248
6373,5254173520,1062,2,121,135,256
6374,5254173520,1062,3,140,107,247
6375,5254173520,1062,4,121,128,249
6376,5254173520,1062,5,130,123,253
6377,5254173520,1062,6,111,136,247
6378,5254173648,1063,1,138,109,247
6379,5254173648,1063,2,118,139,257
6380,5254173648,1063,3,137,114,251
6381,5254173648,1063,4,121,129,250
6382,5254173648,1063,5,132,114,246
6383,5254173648,1063,6,112,137,249
6384,5254173776,1064,1,118,122,240
6385,5254173776,1064,2,126,117,243
6386,5254173776,1064,3,141,110,251
6387,5254173776,1064,4,122,141,263
6388,5254173776,1064,5,135,120,255
6389,5254173776,1064,6,116,132,248
6390,5254174160,1065,1,114,126,240
6391,5254174160,1065,2,116,125,241
6392,5254174160,1065,3,145,106,251
6393,5254174160,1065,4,129,118,247
6394,5254174160,1065,5,131,130,261
6395,5254174160,1065,6,123,137,260
6396,5254174288,1066,1,134,120,254
6397,5254174288,1066,2,121,126,247
6398,5254174288,1066,3,135,118,253
6399,5254174288,1066,4,125,116,241
6400,5254174288,1066,5,128,134,262
6401,5254174288,1066,6,115,128,243
6402,5254174416,1067,1,144,119,263
6403,5254174416,1067,2,133,123,256
6404,5254174416,1067,3,120,133,253
6405,5254174416,1067,4,130,119,249
6406,5254174416,1067,5,117,120,237
6407,5254174416,1067,6,114,128,242
6408,5254174544,1068,1,135,117,252
6409,5254174544,1068,2,134,115,249
6410,5254174544,1068,3,127,126,253
6411,5254174544,1068,4,119,126,245
6412,5254174544,1068,5,127,111,238
6413,5254174544,1068,6,116,147,263
6414,5254174672,1069,1,135,117,252
6415,5254174672,1069,2,143,119,262
6416,5254174672,1069,3,118,122,240
6417,5254174672,1069,4,119,126,245
6418,5254174672,1069,5,138,124,262
6419,5254174672,1069,6,105,134,239
6420,5254174800,1070,1,135,117,252
6421,5254174800,1070,2,143,119,262
6422,5254174800,1070,3,118,122,240
6423,5254174800,1070,4,119,126,245
6424,5254174800,1070,5,133,117,250
6425,5254174800,1070,6,110,141,251
6426,5254174928,1071,1,135,117,252
6427,5254174928,1071,2,143,119,262
6428,5254174928,1071,3,118,122,240
6429,5254174928,1071,4,119,126,245
6430,5254174928,1071,5,131,116,247
6431,5254174928,1071,6,112,142,254
6432,5254175056,1072,1,135,117,252
6433,5254175056,1072,2,143,119,262
6434,5254175056,1072,3,122,134,256
6435,5254175056,1072,4,119,126,245
6436,5254175056,1072,5,131,116,247
6437,5254175056,1072,6,108,130,238
6438,5254175184,1073,1,127,114,241
6439,5254175184,1073,2,130,123,253
6440,5254175184,1073,3,130,109,239
6441,5254175184,1073,4,122,128,250
6442,5254175184,1073,5,127,128,255
6443,5254175184,1073,6,122,140,262
6444,5254175312,1074,1,140,119,259
6445,5254175312,1074,2,126,124,250
6446,5254175312,1074,3,138,123,261
6447,5254175312,1074,4,123,128,251
6448,5254175312,1074,5,121,117,238
6449,5254175312,1074,6,110,131,241
6450,5254175440,1075,1,129,129,258
6451,5254175440,1075,2,147,110,257
6452,5254175440,1075,3,123,123,246
6453,5254175440,1075,4,125,119,244
6454,5254175440,1075,5,126,118,244
6455,5254175440,1075,6,108,143,251
6456,5254175568,1076,1,134,116,250
6457,5254175568,1076,2,145,115,260
6458,5254175568,1076,3,136,121,257
6459,5254175568,1076,4,118,134,252
6460,5254175568,1076,5,117,121,238
6461,5254175568,1076,6,108,135,243
6462,5254175696,1077,1,130,113,243
6463,5254175696,1077,2,133,104,237
6464,5254175696,1077,3,121,122,243
6465,5254175696,1077,4,122,137,259
6466,5254175696,1077,5,133,123,256
6467,5254175696,1077,6,119,143,262
6468,5254175824,1078,1,130,113,243
6469,5254175824,1078,2,128,112,240
6470,5254175824,1078,3,126,114,240
6471,5254175824,1078,4,122,137,259
6472,5254175824,1078,5,133,123,256
6473,5254175824,1078,6,119,143,262
6474,5254175952,1079,1,130,113,243
6475,5254175952,1079,2,128,112,240
6476,5254175952,1079,3,130,123,253
6477,5254175952,1079,4,122,137,259
6478,5254175952,1079,5,127,128,255
6479,5254175952,1079,6,121,129,250
6480,5254176080,1080,1,128,121,249
6481,5254176080,1080,2,145,112,257
6482,5254176080,1080,3,109,138,247
6483,5254176080,1080,4,116,124,240
6484,5254176080,1080,5,143,118,261
6485,5254176080,1080,6,117,129,246
6486,5254176208,1081,1,138,109,247
6487,5254176208,1081,2,134,103,237
6488,5254176208,1081,3,114,140,254
6489,5254176208,1081,4,122,137,259
6490,5254176208,1081,5,129,128,257
6491,5254176208,1081,6,121,125,246
6492,5254176336,1082,1,147,108,255
6493,5254176336,1082,2,133,128,261
6494,5254176336,1082,3,128,111,239
6495,5254176336,1082,4,112,132,244
6496,5254176336,1082,5,120,132,252
6497,5254176336,1082,6,118,131,249
6498,5254176464,1083,1,141,107,248
6499,5254176464,1083,2,131,126,257
6500,5254176464,1083,3,119,119,238
6501,5254176464,1083,4,124,116,240
6502,5254176464,1083,5,129,131,260
6503,5254176464,1083,6,114,143,257
6504,5254176592,1084,1,143,105,248
6505,5254176592,1084,2,124,125,249
6506,5254176592,1084,3,118,131,249
6507,5254176592,1084,4,128,118,246
6508,5254176592,1084,5,131,128,259
6509,5254176592,1084,6,114,135,249
6510,5254176720,1085,1,122,136,258
6511,5254176720,1085,2,122,126,248
6512,5254176720,1085,3,140,118,258
6513,5254176720,1085,4,140,113,253
6514,5254176720,1085,5,115,123,238
6515,5254176720,1085,6,119,126,245
6516,5256384656,1086,1,122,132,254
6517,5256384656,1086,2,121,131,252
6518,5256384656,1086,3,136,103,239
6519,5256384656,1086,4,127,110,237
6520,5256384656,1086,5,125,131,256
6521,5256384656,1086,6,127,135,262
6522,5256384784,1087,1,129,128,257
6523,5256384784,1087,2,113,132,245
6524,5256384784,1087,3,135,113,248
6525,5256384784,1087,4,133,118,251
6526,5256384784,1087,5,121,122,243
6527,5256384784,1087,6,127,129,256
6528,5256384912,1088,1,117,127,244
6529,5256384912,1088,2,126,136,262
6530,5256384912,1088,3,135,113,248
6531,5256384912,1088,4,132,115,247
6532,5256384912,1088,5,121,122,243
6533,5256384912,1088,6,127,129,256
6534,5256385040,1089,1,113,126,239
6535,5256385040,1089,2,135,114,249
6536,5256385040,1089,3,145,111,256
6537,5256385040,1089,4,136,121,257
6538,5256385040,1089,5,108,130,238
6539,5256385040,1089,6,121,140,261
6540,5256385296,1090,1,126,125,251
6541,5256385296,1090,2,140,107,247
6542,5256385296,1090,3,121,122,243
6543,5256385296,1090,4,119,126,245
6544,5256385296,1090,5,126,130,256
6545,5256385296,1090,6,126,132,258
6546,5256385424,1091,1,129,128,257
6547,5256385424,1091,2,128,112,240
6548,5256385424,1091,3,124,134,258
6549,5256385424,1091,4,127,121,248
6550,5256385424,1091,5,135,114,249
6551,5256385424,1091,6,115,133,248
6552,5256385552,1092,1,117,127,244
6553,5256385552,1092,2,135,116,251
6554,5256385552,1092,3,115,138,253
6555,5256385552,1092,4,128,122,250
6556,5256385552,1092,5,145,105,250
6557,5256385552,1092,6,118,134,252
6558,5256385680,1093,1,116,132,248
6559,5256385680,1093,2,126,134,260
6560,5256385680,1093,3,121,125,246
6561,5256385680,1093,4,118,125,243
6562,5256385680,1093,5,141,101,242
6563,5256385680,1093,6,136,125,261
6564,5256385808,1094,1,117,127,244
6565,5256385808,1094,2,126,128,254
6566,5256385808,1094,3,121,137,258
6567,5256385808,1094,4,131,118,249
6568,5256385808,1094,5,126,126,252
6569,5256385808,1094,6,137,106,243
6570,5256385936,1095,1,108,129,237
6571,5256385936,1095,2,145,115,260
6572,5256385936,1095,3,135,119,254
6573,5256385936,1095,4,128,121,249
6574,5256385936,1095,5,113,126,239
6575,5256385936,1095,6,129,132,261
6576,5256386064,1096,1,108,129,237
6577,5256386064,1096,2,145,115,260
6578,5256386064,1096,3,135,119,254
6579,5256386064,1096,4,129,120,249
6580,5256386064,1096,5,113,126,239
6581,5256386064,1096,6,128,133,261
6582,5256386192,1097,1,121,135,256
6583,5256386192,1097,2,145,115,260
6584,5256386192,1097,3,135,126,261
6585,5256386192,1097,4,123,115,238
6586,5256386192,1097,5,113,126,239
6587,5256386192,1097,6,121,125,246
6588,5256386320,1098,1,117,140,257
6589,5256386320,1098,2,142,107,249
6590,5256386320,1098,3,120,119,239
6591,5256386320,1098,4,132,110,242
6592,5256386320,1098,5,127,134,261
6593,5256386320,1098,6,120,132,252
6594,5256386448,1099,1,117,140,257
6595,5256386448,1099,2,142,107,249
6596,5256386448,1099,3,120,119,239
6597,5256386448,1099,4,136,119,255
6598,5256386448,1099,5,127,134,261
6599,5256386448,1099,6,116,123,239
6600,5256386576,1100,1,121,135,256
6601,5256386576,1100,2,134,111,245
6602,5256386576,1100,3,122,137,259
6603,5256386576,1100,4,134,110,244
6604,5256386576,1100,5,113,126,239
6605,5256386576,1100,6,134,123,257
6606,5256386704,1101,1,111,136,247
6607,5256386704,1101,2,115,135,250
6608,5256386704,1101,3,135,107,242
6609,5256386704,1101,4,120,129,249
6610,5256386704,1101,5,132,120,252
6611,5256386704,1101,6,145,115,260
6612,5256386832,1102,1,115,132,247
6613,5256386832,1102,2,133,125,258
6614,5256386832,1102,3,145,117,262
6615,5256386832,1102,4,128,115,243
6616,5256386832,1102,5,116,130,246
6617,5256386832,1102,6,121,123,244
6618,5256386960,1103,1,124,130,254
6619,5256386960,1103,2,111,129,240
6620,5256386960,1103,3,148,112,260
6621,5256386960,1103,4,122,122,244
6622,5256386960,1103,5,122,127,249
6623,5256386960,1103,6,131,122,253
6624,5256387088,1104,1,114,127,241
6625,5256387088,1104,2,119,135,254
6626,5256387088,1104,3,145,107,252
6627,5256387088,1104,4,139,118,257
6628,5256387088,1104,5,122,136,258
6629,5256387088,1104,6,119,119,238
6630,5256387216,1105,1,113,141,254
6631,5256387216,1105,2,126,114,240
6632,5256387216,1105,3,144,112,256
6633,5256387216,1105,4,129,126,255
6634,5256387216,1105,5,124,127,251
6635,5256387216,1105,6,122,122,244
6636,5256387344,1106,1,112,143,255
6637,5256387344,1106,2,133,112,245
6638,5256387344,1106,3,144,112,256
6639,5256387344,1106,4,129,126,255
6640,5256387344,1106,5,124,127,251
6641,5256387344,1106,6,116,122,238
6642,5256387472,1107,1,114,123,237
6643,5256387472,1107,2,146,109,255
6644,5256387472,1107,3,140,118,258
6645,5256387472,1107,4,118,127,245
6646,5256387472,1107,5,122,141,263
6647,5256387472,1107,6,118,124,242
6648,5256387600,1108,1,121,131,252
6649,5256387600,1108,2,146,109,255
6650,5256387600,1108,3,140,118,258
6651,5256387600,1108,4,118,127,245
6652,5256387600,1108,5,112,132,244
6653,5256387600,1108,6,121,125,246
6654,5256387728,1109,1,113,124,237
6655,5256387728,1109,2,146,109,255
6656,5256387728,1109,3,140,118,258
6657,5256387728,1109,4,118,127,245
6658,5256387728,1109,5,122,141,263
6659,5256387728,1109,6,119,123,242
6660,5256387856,1110,1,113,124,237
6661,5256387856,1110,2,146,109,255
6662,5256387856,1110,3,140,118,258
6663,5256387856,1110,4,118,127,245
6664,5256387856,1110,5,112,132,244
6665,5256387856,1110,6,129,132,261
6666,5256388112,1111,1,115,122,237
6667,5256388112,1111,2,147,105,252
6668,5256388112,1111,3,131,126,257
6669,5256388112,1111,4,119,125,244
6670,5256388112,1111,5,117,130,247
6671,5256388112,1111,6,129,134,263
6672,5256388240,1112,1,119,132,251
6673,5256388240,1112,2,139,112,251
6674,5256388240,1112,3,140,117,257
6675,5256388240,1112,4,114,127,241
6676,5256388240,1112,5,116,134,250
6677,5256388240,1112,6,130,120,250
6678,5256388496,1113,1,118,131,249
6679,5256388496,1113,2,132,130,262
6680,5256388496,1113,3,131,123,254
6681,5256388496,1113,4,132,121,253
6682,5256388496,1113,5,126,112,238
6683,5256388496,1113,6,119,125,244
6684,5258616912,1114,1,108,143,251
6685,5258616912,1114,2,121,125,246
6686,5258616912,1114,3,129,128,257
6687,5258616912,1114,4,134,111,245
6688,5258616912,1114,5,134,108,242
6689,5258616912,1114,6,132,127,259
6690,5258617040,1115,1,121,137,258
6691,5258617040,1115,2,124,123,247
6692,5258617040,1115,3,122,126,248
6693,5258617040,1115,4,128,124,252
6694,5258617040,1115,5,143,106,249
6695,5258617040,1115,6,120,126,246
6696,5258617168,1116,1,116,122,238
6697,5258617168,1116,2,131,116,247
6698,5258617168,1116,3,130,122,252
6699,5258617168,1116,4,126,121,247
6700,5258617168,1116,5,120,142,262
6701,5258617168,1116,6,135,119,254
6702,5258617296,1117,1,122,124,246
6703,5258617296,1117,2,131,116,247
6704,5258617296,1117,3,130,122,252
6705,5258617296,1117,4,126,121,247
6706,5258617296,1117,5,114,140,254
6707,5258617296,1117,6,135,119,254
6708,5258617424,1118,1,122,124,246
6709,5258617424,1118,2,131,116,247
6710,5258617424,1118,3,118,119,237
6711,5258617424,1118,4,138,124,262
6712,5258617424,1118,5,114,140,254
6713,5258617424,1118,6,135,119,254
6714,5258617552,1119,1,124,114,238
6715,5258617552,1119,2,123,127,250
6716,5258617552,1119,3,147,112,259
6717,5258617552,1119,4,115,123,238
6718,5258617552,1119,5,117,138,255
6719,5258617552,1119,6,132,128,260
6720,5258617680,1120,1,122,138,260
6721,5258617680,1120,2,124,114,238
6722,5258617680,1120,3,145,106,251
6723,5258617680,1120,4,121,124,245
6724,5258617680,1120,5,115,134,249
6725,5258617680,1120,6,131,126,257
6726,5258617808,1121,1,113,124,237
6727,5258617808,1121,2,130,126,256
6728,5258617808,1121,3,147,110,257
6729,5258617808,1121,4,126,128,254
6730,5258617808,1121,5,116,132,248
6731,5258617808,1121,6,126,122,248
6732,5258617936,1122,1,119,130,249
6733,5258617936,1122,2,124,120,244
6734,5258617936,1122,3,147,110,257
6735,5258617936,1122,4,126,128,254
6736,5258617936,1122,5,116,132,248
6737,5258617936,1122,6,126,122,248
6738,5258618064,1123,1,122,123,245
6739,5258618064,1123,2,136,121,257
6740,5258618064,1123,3,139,119,258
6741,5258618064,1123,4,133,124,257
6742,5258618064,1123,5,115,129,244
6743,5258618064,1123,6,113,126,239
6744,5258618192,1124,1,110,133,243
6745,5258618192,1124,2,136,115,251
6746,5258618192,1124,3,143,106,249
6747,5258618192,1124,4,126,131,257
6748,5258618192,1124,5,132,124,256
6749,5258618192,1124,6,111,133,244
6750,5258618448,1125,1,115,138,253
6751,5258618448,1125,2,131,124,255
6752,5258618448,1125,3,138,105,243
6753,5258618448,1125,4,117,126,243
6754,5258618448,1125,5,138,123,261
6755,5258618448,1125,6,119,126,245
6756,5258618704,1126,1,120,142,262
6757,5258618704,1126,2,134,126,260
6758,5258618704,1126,3,140,103,243
6759,5258618704,1126,4,119,125,244
6760,5258618704,1126,5,132,120,252
6761,5258618704,1126,6,113,126,239
6762,5258618960,1127,1,116,137,253
6763,5258618960,1127,2,134,126,260
6764,5258618960,1127,3,140,103,243
6765,5258618960,1127,4,119,125,244
6766,5258618960,1127,5,136,125,261
6767,5258618960,1127,6,113,126,239
6768,5258619088,1128,1,124,114,238
6769,5258619088,1128,2,127,136,263
6770,5258619088,1128,3,121,133,254
6771,5258619088,1128,4,141,113,254
6772,5258619088,1128,5,124,128,252
6773,5258619088,1128,6,121,118,239
6774,5258619344,1129,1,109,131,240
6775,5258619344,1129,2,126,128,254
6776,5258619344,1129,3,114,140,254
6777,5258619344,1129,4,144,107,251
6778,5258619344,1129,5,144,113,257
6779,5258619344,1129,6,121,123,244
6780,5258619472,1130,1,126,123,249
6781,5258619472,1130,2,126,133,259
6782,5258619472,1130,3,112,130,242
6783,5258619472,1130,4,128,124,252
6784,5258619472,1130,5,131,113,244
6785,5258619472,1130,6,135,119,254
6786,5258619600,1131,1,113,130,243
6787,5258619600,1131,2,123,123,246
6788,5258619600,1131,3,132,128,260
6789,5258619600,1131,4,120,129,249
6790,5258619600,1131,5,137,103,240
6791,5258619600,1131,6,133,129,262
6792,5258619728,1132,1,113,130,243
6793,5258619728,1132,2,123,123,246
6794,5258619728,1132,3,124,125,249
6795,5258619728,1132,4,118,122,240
6796,5258619728,1132,5,147,113,260
6797,5258619728,1132,6,133,129,262
6798,5258619856,1133,1,113,130,243
6799,5258619856,1133,2,123,123,246
6800,5258619856,1133,3,124,125,249
6801,5258619856,1133,4,130,132,262
6802,5258619856,1133,5,135,103,238
6803,5258619856,1133,6,133,129,262
6804,5258619984,1134,1,121,126,247
6805,5258619984,1134,2,118,123,241
6806,5258619984,1134,3,123,116,239
6807,5258619984,1134,4,122,133,255
6808,5258619984,1134,5,145,115,260
6809,5258619984,1134,6,129,129,258
6810,5258620112,1135,1,137,120,257
6811,5258620112,1135,2,118,131,249
6812,5258620112,1135,3,114,126,240
6813,5258620112,1135,4,111,130,241
6814,5258620112,1135,5,142,113,255
6815,5258620112,1135,6,136,122,258
6816,5258620368,1136,1,123,123,246
6817,5258620368,1136,2,129,131,260
6818,5258620368,1136,3,118,139,257
6819,5258620368,1136,4,125,115,240
6820,5258620368,1136,5,142,111,253
6821,5258620368,1136,6,121,123,244
6822,5258620496,1137,1,124,117,241
6823,5258620496,1137,2,126,134,260
6824,5258620496,1137,3,112,131,243
6825,5258620496,1137,4,120,125,245
6826,5258620496,1137,5,141,111,252
6827,5258620496,1137,6,135,124,259
6828,5258620624,1138,1,127,136,263
6829,5258620624,1138,2,126,131,257
6830,5258620624,1138,3,116,121,237
6831,5258620624,1138,4,128,116,244
6832,5258620624,1138,5,136,111,247
6833,5258620624,1138,6,125,127,252
6834,5258620752,1139,1,137,124,261
6835,5258620752,1139,2,128,121,249
6836,5258620752,1139,3,116,132,248
6837,5258620752,1139,4,117,125,242
6838,5258620752,1139,5,144,113,257
6839,5258620752,1139,6,116,127,243
6840,5258620880,1140,1,129,112,241
6841,5258620880,1140,2,127,118,245
6842,5258620880,1140,3,116,132,248
6843,5258620880,1140,4,125,137,262
6844,5258620880,1140,5,144,113,257
6845,5258620880,1140,6,117,130,247
6846,5260832912,1141,1,113,125,238
6847,5260832912,1141,2,143,105,248
6848,5260832912,1141,3,125,135,260
6849,5260832912,1141,4,123,124,247
6850,5260832912,1141,5,132,122,254
6851,5260832912,1141,6,122,131,253
6852,5260833040,1142,1,115,128,243
6853,5260833040,1142,2,144,106,250
6854,5260833040,1142,3,131,125,256
6855,5260833040,1142,4,112,131,243
6856,5260833040,1142,5,134,124,258
6857,5260833040,1142,6,122,128,250
6858,5260833168,1143,1,136,123,259
6859,5260833168,1143,2,147,112,259
6860,5260833168,1143,3,123,132,255
6861,5260833168,1143,4,115,133,248
6862,5260833168,1143,5,124,116,240
6863,5260833168,1143,6,113,126,239
6864,5260833296,1144,1,136,123,259
6865,5260833296,1144,2,141,109,250
6866,5260833296,1144,3,123,132,255
6867,5260833296,1144,4,115,133,248
6868,5260833296,1144,5,130,119,249
6869,5260833296,1144,6,113,126,239
6870,5260833424,1145,1,129,114,243
6871,5260833424,1145,2,131,123,254
6872,5260833424,1145,3,122,136,258
6873,5260833424,1145,4,124,123,247
6874,5260833424,1145,5,129,127,256
6875,5260833424,1145,6,123,119,242
6876,5260833552,1146,1,129,114,243
6877,5260833552,1146,2,135,123,258
6878,5260833552,1146,3,122,136,258
6879,5260833552,1146,4,120,123,243
6880,5260833552,1146,5,129,127,256
6881,5260833552,1146,6,123,119,242
6882,5260833680,1147,1,128,116,244
6883,5260833680,1147,2,123,117,240
6884,5260833680,1147,3,123,134,257
6885,5260833680,1147,4,120,123,243
6886,5260833680,1147,5,129,127,256
6887,5260833680,1147,6,135,125,260
6888,5260833808,1148,1,122,126,248
6889,5260833808,1148,2,128,120,248
6890,5260833808,1148,3,121,123,244
6891,5260833808,1148,4,114,132,246
6892,5260833808,1148,5,148,113,261
6893,5260833808,1148,6,125,128,253
6894,5260834064,1149,1,107,132,239
6895,5260834064,1149,2,127,114,241
6896,5260834064,1149,3,130,120,250
6897,5260834064,1149,4,131,129,260
6898,5260834064,1149,5,140,117,257
6899,5260834064,1149,6,123,130,253
6900,5260834192,1150,1,107,132,239
6901,5260834192,1150,2,135,121,256
6902,5260834192,1150,3,130,120,250
6903,5260834192,1150,4,123,122,245
6904,5260834192,1150,5,140,117,257
6905,5260834192,1150,6,123,130,253
6906,5260834320,1151,1,108,130,238
6907,5260834320,1151,2,135,121,256
6908,5260834320,1151,3,130,120,250
6909,5260834320,1151,4,122,124,246
6910,5260834320,1151,5,140,117,257
6911,5260834320,1151,6,123,130,253
6912,5260834448,1152,1,107,132,239
6913,5260834448,1152,2,120,132,252
6914,5260834448,1152,3,139,101,240
6915,5260834448,1152,4,135,123,258
6916,5260834448,1152,5,135,117,252
6917,5260834448,1152,6,122,137,259
6918,5260834576,1153,1,118,139,257
6919,5260834576,1153,2,143,120,263
6920,5260834576,1153,3,131,112,243
6921,5260834576,1153,4,117,129,246
6922,5260834576,1153,5,127,110,237
6923,5260834576,1153,6,122,132,254
6924,5260834704,1154,1,116,142,258
6925,5260834704,1154,2,128,121,249
6926,5260834704,1154,3,146,116,262
6927,5260834704,1154,4,115,125,240
6928,5260834704,1154,5,135,119,254
6929,5260834704,1154,6,118,119,237
6930,5260834960,1155,1,116,142,258
6931,5260834960,1155,2,123,120,243
6932,5260834960,1155,3,139,114,253
6933,5260834960,1155,4,115,125,240
6934,5260834960,1155,5,134,111,245
6935,5260834960,1155,6,131,130,261
6936,5260835088,1156,1,109,130,239
6937,5260835088,1156,2,127,128,255
6938,5260835088,1156,3,134,114,248
6939,5260835088,1156,4,124,133,257
6940,5260835088,1156,5,140,112,252
6941,5260835088,1156,6,124,125,249
6942,5260835216,1157,1,116,142,258
6943,5260835216,1157,2,127,128,255
6944,5260835216,1157,3,134,114,248
6945,5260835216,1157,4,117,121,238
6946,5260835216,1157,5,140,112,252
6947,5260835216,1157,6,124,125,249
6948,5260835344,1158,1,119,128,247
6949,5260835344,1158,2,138,124,262
6950,5260835344,1158,3,126,126,252
6951,5260835344,1158,4,112,130,242
6952,5260835344,1158,5,134,112,246
6953,5260835344,1158,6,129,122,251
6954,5260835472,1159,1,118,140,258
6955,5260835472,1159,2,120,119,239
6956,5260835472,1159,3,134,121,255
6957,5260835472,1159,4,129,122,251
6958,5260835472,1159,5,121,123,244
6959,5260835472,1159,6,136,117,253
6960,5260835600,1160,1,133,128,261
6961,5260835600,1160,2,120,130,250
6962,5260835600,1160,3,131,110,241
6963,5260835600,1160,4,119,126,245
6964,5260835600,1160,5,123,118,241
6965,5260835600,1160,6,132,130,262
6966,5260835728,1161,1,113,137,250
6967,5260835728,1161,2,132,122,254
6968,5260835728,1161,3,142,115,257
6969,5260835728,1161,4,133,126,259
6970,5260835728,1161,5,123,119,242
6971,5260835728,1161,6,115,123,238
6972,5260835856,1162,1,115,129,244
6973,5260835856,1162,2,138,115,253
6974,5260835856,1162,3,144,110,254
6975,5260835856,1162,4,124,133,257
6976,5260835856,1162,5,117,130,247
6977,5260835856,1162,6,120,125,245
6978,5260835984,1163,1,114,140,254
6979,5260835984,1163,2,141,121,262
6980,5260835984,1163,3,131,116,247
6981,5260835984,1163,4,118,122,240
6982,5260835984,1163,5,113,126,239
6983,5260835984,1163,6,141,117,258
6984,5260836112,1164,1,125,120,245
6985,5260836112,1164,2,126,119,245
6986,5260836112,1164,3,140,110,250
6987,5260836112,1164,4,117,143,260
6988,5260836112,1164,5,117,130,247
6989,5260836112,1164,6,133,120,253
6990,5260836240,1165,1,126,137,263
6991,5260836240,1165,2,130,115,245
6992,5260836240,1165,3,141,111,252
6993,5260836240,1165,4,114,132,246
6994,5260836240,1165,5,117,127,244
6995,5260836240,1165,6,130,120,250
6996,5260836368,1166,1,119,123,242
6997,5260836368,1166,2,131,121,252
6998,5260836368,1166,3,125,119,244
6999,5260836368,1166,4,110,131,241
7000,5260836368,1166,5,129,129,258
7001,5260836368,1166,6,144,119,263
7002,5260836496,1167,1,138,119,257
7003,5260836496,1167,2,120,130,250
7004,5260836496,1167,3,122,119,241
7005,5260836496,1167,4,115,135,250
7006,5260836496,1167,5,132,129,261
7007,5260836496,1167,6,131,110,241
7008,5260836624,1168,1,128,128,256
7009,5260836624,1168,2,122,120,242
7010,5260836624,1168,3,122,119,241
7011,5260836624,1168,4,123,136,259
7012,5260836624,1168,5,132,129,261
7013,5260836624,1168,6,131,110,241
7014,5260836752,1169,1,118,120,238
7015,5260836752,1169,2,128,125,253
7016,5260836752,1169,3,141,120,261
7017,5260836752,1169,4,116,142,258
7018,5260836752,1169,5,117,121,238
7019,5260836752,1169,6,138,114,252
7020,5263069264,1170,1,116,134,250
7021,5263069264,1170,2,130,123,253
7022,5263069264,1170,3,123,132,255
7023,5263069264,1170,4,114,132,246
7024,5263069264,1170,5,140,118,258
7025,5263069264,1170,6,135,103,238
7026,5263069392,1171,1,142,113,255
7027,5263069392,1171,2,125,128,253
7028,5263069392,1171,3,126,129,255
7029,5263069392,1171,4,128,118,246
7030,5263069392,1171,5,116,127,243
7031,5263069392,1171,6,121,127,248
7032,5263069520,1172,1,142,113,255
7033,5263069520,1172,2,118,119,237
7034,5263069520,1172,3,126,129,255
7035,5263069520,1172,4,135,127,262
7036,5263069520,1172,5,116,127,243
7037,5263069520,1172,6,121,127,248
7038,5263069648,1173,1,137,114,251
7039,5263069648,1173,2,123,131,254
7040,5263069648,1173,3,130,116,246
7041,5263069648,1173,4,144,116,260
7042,5263069648,1173,5,114,129,243
7043,5263069648,1173,6,110,136,246
7044,5263069776,1174,1,137,114,251
7045,5263069776,1174,2,123,131,254
7046,5263069776,1174,3,139,104,243
7047,5263069776,1174,4,126,122,248
7048,5263069776,1174,5,111,133,244
7049,5263069776,1174,6,122,138,260
7050,5263069904,1175,1,131,108,239
7051,5263069904,1175,2,128,127,255
7052,5263069904,1175,3,146,107,253
7053,5263069904,1175,4,117,127,244
7054,5263069904,1175,5,118,134,252
7055,5263069904,1175,6,118,139,257
7056,5263070032,1176,1,131,113,244
7057,5263070032,1176,2,125,131,256
7058,5263070032,1176,3,138,104,242
7059,5263070032,1176,4,131,124,255
7060,5263070032,1176,5,122,141,263
7061,5263070032,1176,6,111,129,240
7062,5263070160,1177,1,131,113,244
7063,5263070160,1177,2,125,131,256
7064,5263070160,1177,3,138,104,242
7065,5263070160,1177,4,131,124,255
7066,5263070160,1177,5,115,131,246
7067,5263070160,1177,6,118,139,257
7068,5263070288,1178,1,133,112,245
7069,5263070288,1178,2,134,125,259
7070,5263070288,1178,3,143,111,254
7071,5263070288,1178,4,114,135,249
7072,5263070288,1178,5,113,126,239
7073,5263070288,1178,6,121,133,254
7074,5263070416,1179,1,133,112,245
7075,5263070416,1179,2,130,118,248
7076,5263070416,1179,3,143,111,254
7077,5263070416,1179,4,118,142,260
7078,5263070416,1179,5,113,126,239
7079,5263070416,1179,6,121,133,254
7080,5263070672,1180,1,130,125,255
7081,5263070672,1180,2,114,126,240
7082,5263070672,1180,3,147,110,257
7083,5263070672,1180,4,109,131,240
7084,5263070672,1180,5,132,121,253
7085,5263070672,1180,6,126,129,255
7086,5263070928,1181,1,129,129,258
7087,5263070928,1181,2,122,117,239
7088,5263070928,1181,3,146,104,250
7089,5263070928,1181,4,115,142,257
7090,5263070928,1181,5,125,119,244
7091,5263070928,1181,6,121,131,252
7092,5263071056,1182,1,126,128,254
7093,5263071056,1182,2,122,125,247
7094,5263071056,1182,3,146,110,256
7095,5263071056,1182,4,117,125,242
7096,5263071056,1182,5,130,127,257
7097,5263071056,1182,6,117,127,244
7098,5263071184,1183,1,113,126,239
7099,5263071184,1183,2,123,114,237
7100,5263071184,1183,3,139,104,243
7101,5263071184,1183,4,117,143,260
7102,5263071184,1183,5,135,128,263
7103,5263071184,1183,6,131,127,258
7104,5263071312,1184,1,123,119,242
7105,5263071312,1184,2,138,105,243
7106,5263071312,1184,3,124,134,258
7107,5263071312,1184,4,119,143,262
7108,5263071312,1184,5,131,112,243
7109,5263071312,1184,6,123,129,252
7110,5263071440,1185,1,116,134,250
7111,5263071440,1185,2,142,103,245
7112,5263071440,1185,3,124,116,240
7113,5263071440,1185,4,113,150,263
7114,5263071440,1185,5,135,118,253
7115,5263071440,1185,6,128,121,249
7116,5263071568,1186,1,116,134,250
7117,5263071568,1186,2,142,103,245
7118,5263071568,1186,3,124,116,240
7119,5263071568,1186,4,113,150,263
7120,5263071568,1186,5,132,115,247
7121,5263071568,1186,6,131,124,255
7122,5263071696,1187,1,133,122,255
7123,5263071696,1187,2,126,121,247
7124,5263071696,1187,3,126,137,263
7125,5263071696,1187,4,121,124,245
7126,5263071696,1187,5,125,119,244
7127,5263071696,1187,6,127,119,246
7128,5263071824,1188,1,123,139,262
7129,5263071824,1188,2,116,129,245
7130,5263071824,1188,3,134,116,250
7131,5263071824,1188,4,129,119,248
7132,5263071824,1188,5,125,117,242
7133,5263071824,1188,6,131,122,253
7134,5263071952,1189,1,114,128,242
7135,5263071952,1189,2,116,129,245
7136,5263071952,1189,3,134,116,250
7137,5263071952,1189,4,129,119,248
7138,5263071952,1189,5,134,128,262
7139,5263071952,1189,6,131,122,253
7140,5263072080,1190,1,126,128,254
7141,5263072080,1190,2,117,130,247
7142,5263072080,1190,3,117,124,241
7143,5263072080,1190,4,124,121,245
7144,5263072080,1190,5,144,119,263
7145,5263072080,1190,6,130,120,250
7146,5263072208,1191,1,122,141,263
7147,5263072208,1191,2,110,141,251
7148,5263072208,1191,3,134,116,250
7149,5263072208,1191,4,130,124,254
7150,5263072208,1191,5,134,110,244
7151,5263072208,1191,6,128,110,238
7152,5263072336,1192,1,115,131,246
7153,5263072336,1192,2,116,142,258
7154,5263072336,1192,3,125,115,240
7155,5263072336,1192,4,128,125,253
7156,5263072336,1192,5,134,110,244
7157,5263072336,1192,6,140,119,259
7158,5263072464,1193,1,121,135,256
7159,5263072464,1193,2,121,133,254
7160,5263072464,1193,3,116,123,239
7161,5263072464,1193,4,129,121,250
7162,5263072464,1193,5,140,115,255
7163,5263072464,1193,6,131,115,246
